原書詞頭	简体	OpenCC格式	吳拼
之前	之前	之前	tsy zhi
之後	之后	之後	tsy gheu
支光	支光	支光	tsy kuaon
芝麻	芝麻	芝麻	tsy mo
脂麻	脂麻	脂麻	tsy mo
芝麻醬	芝麻酱	芝麻醬	tsy mo cian
梔珠花	栀珠花	梔珠花	tsy tsyu huo
鯔魚	鲻鱼	鯔魚	tsy ng
子	子	子	tsy3
子女	子女	子女	tsy gniu
子蟹	子蟹	子蟹	tsy ha
子蝦	子虾	子蝦	tsy huo
子孫	子孙	子孫	tsy sen
子孔頭	子孔头	子孔頭	tsy khon deu
仔	仔	仔	tsy3
仔潔	仔洁	仔潔	tsy ciq
指末頭	指末头	指末頭	tsy maq deu
指掐	指掐	指掐	tsy khaq
指掐深	指掐深	指掐深	tsy khaq shin
指掐縫道	指掐缝道	指掐縫道	tsy khaq von dau
紙糊頭	纸糊头	紙糊頭	tsy wu deu
紙頭	纸头	紙頭	tsy deu
紙行	纸行	紙行	tsy ghaon
紙襞箱	纸襞箱	紙襞箱	tsy paq shian
紙箱店	纸箱店	紙箱店	tsy shian ti
煮	煮	煮	tsy3
煮下飯	煮下饭	煮下飯	tsy gho vae
紫	紫	紫	tsy3
紫胡萄	紫胡萄	紫胡萄	tsy wu dau
紫菜	紫菜	紫菜	tsy tshe
紫檀	紫檀	紫檀	tsy dae
紫絳紅	紫绛红	紫絳紅	tsy cian ghon
紫藤	紫藤	紫藤	tsy den
紫銅	紫铜	紫銅	tsy don
紫答答	紫答答	紫答答	tsy taq taq
紫竹	紫竹	紫竹	tsy tsoq
紫殼蟹	紫壳蟹	紫殼蟹	tsy khoq ha
紫血	紫血	紫血	tsy shiuq
紫血泡	紫血泡	紫血泡	tsy shiuq phau
痣	痣	痣	tsy5
雌驢	雌驴	雌驢	tshy lu
雌鷄胡嚨	雌鸡胡咙	雌雞胡嚨	tshy ci wu lon
雌老虎	雌老虎	雌老虎	tshy lau fu
次毛	次毛	次毛	tshy mau
刺柴	刺柴	刺柴	tshy za
刺柴條	刺柴条	刺柴條	tshy za diau
刺人	刺人	刺人	tshy gnin
刺戳	刺戳	刺戳	tshy tshoq
廁所間	厕所间	廁所間	tshy so kae
瓷器店	瓷器店	瓷器店	dzy chi ti
慈姑	慈姑	慈姑	dzy ku
飼養員	饲养员	飼養員	dzy yan yu
司必靈	司必灵	司必靈	sy piq lin
司必靈鎖	司必灵锁	司必靈鎖	sy piq lin sou
司的克	司的克	司的克	sy tiq khaq
私房	私房	私房	sy vaon
私章	私章	私章	sy tsaon
私行察訪	私行察访	私行察訪	sy ghaon tshaq faon
私塾	私塾	私塾	sy dzoq
屍骨	尸骨	屍骨	sy kuaq
施肥	施肥	施肥	sy vi
施散米	施散米	施散米	sy sae mi
師父	师父	師父	sy vu
師父徒弟	师父徒弟	師父徒弟	sy vu du di
師爺	师爷	師爺	sy ya
師母	师母	師母	sy meu
斯帶脱	斯带脱	斯帶脫	sy ta thaq
斯文	斯文	斯文	sy ven
斯斯文文	斯斯文文	斯斯文文	sy sy ven ven
絲綿	丝绵	絲綿	sy mi
絲綫店	丝线店	絲線店	sy shi ti
絲流	丝流	絲流	sy lieu
絲行	丝行	絲行	sy ghaon
絲襪	丝袜	絲襪	sy maq
獅子	狮子	獅子	sy tsy
獅子飯盂	狮子饭盂	獅子飯盂	sy tsy vae yu
獅子頭	狮子头	獅子頭	sy tsy deu
獅子狗	狮子狗	獅子狗	sy tsy keu
獅子頭狗	狮子头狗	獅子頭狗	sy tsy deu keu
篩穀	筛谷	篩穀	sy koq
筛穀⿱寨	筛谷⿱寨	篩穀⿱寨	sy koq za
螄螺	蛳螺	螄螺	sy lou
梳	梳	梳	sy3
木梳	木梳	木梳	moq sy
梳繞繞頭	梳绕绕头	梳繞繞頭	sy gniau gniau deu
梳頭	梳头	梳頭	sy deu
梳頭家生	梳头家生	梳頭家生	sy deu ko san
梳頭鏡箱	梳头镜箱	梳頭鏡箱	sy deu cin shian
四	四	四	sy5
四肢霉落	四肢霉落	四肢黴落	sy tsy mei loq
四面八方	四面八方	四面八方	sy mi paq faon
四點	四点	四點	sy ti
四軒肉	四轩肉	四軒肉	sy shi gnioq
四號	四号	四號	sy ghau
四方的角	四方的角	四方的角	sy faon tiq koq
四平八穩	四平八稳	四平八穩	sy bin paq uen
四明南詞	四明南词	四明南詞	sy min nEI dzy
四明文書	四明文书	四明文書	sy min ven syu
四通八達	四通八达	四通八達	sy thon paq daq
四隻眼	四只眼	四隻眼	sy tsaq ngae
四腳蛇	四脚蛇	四腳蛇	sy ciaq dzo
四角框	四角框	四角框	sy koq khuaon
四個	四个	四個	sy goq
四個	四个	四個	sy kou
四日兩頭班	四日两头班	四日兩頭班	sy gniq lian deu pae
四一	四一	四一	sy iq
四十一	四十一	四十一	sy zyuq iq
四二	四二	四二	sy gni
四兩	四两	四兩	sy lian
四三	四三	四三	sy sae
四四	四四	四四	sy sy
四五	四五	四五	sy ng
四六	四六	四六	sy loq
四七	四七	四七	sy chiq
四八	四八	四八	sy paq
四九	四九	四九	sy cieu
四十	四十	四十	sy zyuq
時	时	時	zy2
時○件	时○件	時○件	sy ji
時鮮	时鲜	時鮮	zy shi
時雨	时雨	時雨	zy yu
時道	时道	時道	zy dau
時眼	时眼	時眼	zy ngae
時晌	时晌	時晌	zy zaon
時辰	时辰	時辰	zy yin
時格	时格	時格	zy kaq
時疫病	时疫病	時疫病	zy yuq bin
鋤頭	锄头	鋤頭	zy deu
鰣魚	鲥鱼	鰣魚	zy ng
士	士	士	zy4
士林藍	士林蓝	士林藍	zy lin lae
摩登藍	摩登蓝	摩登藍	mou ten lae
巳	巳	巳	zy4
示字旁	示字旁	示字旁	zy zy baon
仕	仕	仕	zy4
市日	市日	市日	zy gniq
市日頭間	市日头间	市日頭間	zy gniq deu kae
自來火	自来火	自來火	zy le hou
洋火	洋火	洋火	yan hou
自來水筆	自来水笔	自來水筆	zy le syu piq
自鳴鐘	自鸣钟	自鳴鍾	zy min tson
自從	自从	自從	zy dzon
自説自話	自说自话	自說自話	zy syuq zy wo
字	字	字	zy6
字號	字号	字號	zy ghau
字帖	字帖	字帖	zy thiaq
事體	事体	事體	zy thi
柿子	柿子	柿子	zy tsy
柿餅	柿饼	柿餅	zy pin
是	是	是	zy4
是介	是介	是介	zy ka
是介光景	是介光景	是介光景	zy ka kuaon cin
是話	是话	是話	zy wo
是會	是会	是會	zy wei
是只	是只	是只	zy ciq
祠堂	祠堂	祠堂	zy daon
支	支	支	tsyu1
朱紅	朱红	硃紅	tsyu ghon
侏	侏	侏	tsyu1
侏栗	侏栗	侏慄	tsyu liq
炷	炷	炷	tsyu1
珠花	珠花	珠花	tsyu huo
株	株	株	tsyu1
蛛蛛	蛛蛛	蛛蛛	tsyu tsyu
蛛蛛網	蛛蛛网	蛛蛛網	tsyu tsyu maon
蛛蛛網絲	蛛蛛网丝	蛛蛛網絲	tsyu tsyu maon sy
主意	主意	主意	tsyu i
主主意意	主主意意	主主意意	tsyu tsyu i i
主人家	主人家	主人家	tsyu gnin ko
豬癲病	猪癫病	豬癲病	tsyu ti bin
豬廐間	猪厩间	豬廄間	tsyu ji kae
豬舍	猪舍	豬舍	tsyu so
豬泥	猪泥	豬泥	tsyu gni
豬肝	猪肝	豬肝	tsyu kI
豬腦	猪脑	豬腦	tsyu nau
豬槽	猪槽	豬槽	tsyu zau
豬油	猪油	豬油	tsyu yeu
豬油餡	猪油馅	豬油餡	tsyu yeu ghae
豬油湯糰	猪油汤团	豬油湯糰	tsyu yeu thaon doe
豬玀	猪猡	豬玀	tsyu lou
豬屙	猪屙	豬屙	tsyu ou
豬娘	猪娘	豬娘	tsyu gnian
豬筋	猪筋	豬筋	tsyu cin
猪心	猪心	豬心	tsyu shin
豬血	猪血	豬血	tsyu shiuq
嘴脯	嘴脯	嘴脯	tsyu bu
嘴巴	嘴巴	嘴巴	tsyu po
嘴巴皮	嘴巴皮	嘴巴皮	tsyu po bi
嘴巴都起	嘴巴都起	嘴巴都起	tsyu po tu chi
嘴巴牢	嘴巴牢	嘴巴牢	tsyu po lau
嘴巴噘噘	嘴巴噘噘	嘴巴噘噘	tsyu po ciuq ciuq
嘴巴嘸味道	嘴巴呒味道	嘴巴嘸味道	tsyu po mh mi dau
嘴唇皮	嘴唇皮	嘴脣皮	tsyu zyun bi
嘴革○	嘴革○	嘴革○	tsyu kaq
嘴角瘡	嘴角疮	嘴角瘡	tsyu koq tshaon
制服	制服	制服	tsyu voq
拄	拄	拄	tsyu5
拄鞋	拄鞋	拄鞋	tsyu gha
注	注	注	tsyu5
注意	注意	注意	tsyu i
疰車	疰车	疰車	tsyu tsho
疰夏	疰夏	疰夏	tsyu gho
疰浪	疰浪	疰浪	tsyu laon
疰船	疰船	疰船	tsyu zOE
蛀牙	蛀牙	蛀牙	tsyu ngo
鑄○	铸○	鑄○	tsyu5
吹吹泡	吹吹泡	吹吹泡	tshyu tshyu phau
吹牛屄	吹牛屄	吹牛屄	tshyu ngeu pi
吹行	吹行	吹行	tshyu ghaon
處暑	处暑	處暑	tshyu syu
取保	取保	取保	tshyu pau
粢飯	粢饭	粢飯	tshyu vae
粢飯糕	粢饭糕	粢飯糕	tshyu vae kau
除䩩	除䩩	除䩩	dzyu iu
廚房間	厨房间	廚房間	dzyu vaon kae
廚工師父	厨工师父	廚工師父	dzyu kon sy vu
廚工	厨工	廚工	dzyu kon
櫥	橱	櫥	dzyu2
住○	住○	住○	dzyu6
住宅	住宅	住宅	dzyu dzaq
治漏	治漏	治漏	dzyu leu
柱○	柱○	柱○	dzyu4
柱底石	柱底石	柱底石	dzyu ti zaq
滯	滞	滯	dzyu6
滯膯	滞膯	滯膯	dzyu ten
缒	缒	縋	dzyu6
尿	尿	尿	syu1
尿泡泡	尿泡泡	尿泡泡	syu phau phau
尿瓶	尿瓶	尿瓶	syu bin
尿衲布	尿衲布	尿衲布	syu naq pu
尿衲	尿衲	尿衲	syu naq
尿急病	尿急病	尿急病	syu ciq bin
書櫥	书橱	書櫥	syu dzyu
書費	书费	書費	syu fi
書店	书店	書店	syu ti
書包	书包	書包	syu pau
書包架	书包架	書包架	syu pau ko
書架	书架	書架	syu ko
書房	书房	書房	syu vaon
書獨頭	书独头	書獨頭	syu doq deu
書大糊	书大糊	書大糊	syu dou wu
書桌	书桌	書桌	syu tsoq
舒意	舒意	舒意	syu i
舒舒意意	舒舒意意	舒舒意意	syu syu i i
舒☐	舒☐	舒☐	syu the
貰	贳	貰	syu1
貰器店	贳器店	貰器店	syu chi ti
貰屋	贳屋	貰屋	syu oq
水	水	水	syu3
水底工	水底工	水底工	syu ti kon
水裏	水里	水裏	syu li
水鷄	水鸡	水雞	syu ci
水泥	水泥	水泥	syu gni
水門汀	水门汀	水門汀	syu men thin
水泥船	水泥船	水泥船	syu gni zOE
水仙花	水仙花	水仙花	syu shi huo
水煙管	水烟管	水菸管	syu i kun
水葫蘆	水葫芦	水葫蘆	syu wu lu
水鳧鷺	水凫鹭	水鳧鷺	syu Wu lu
水渠	水渠	水渠	syu jiu
水牌	水牌	水牌	syu ba
水泡泡	水泡泡	水泡泡	syu phau phau
水稻田	水稻田	水稻田	syu dau di
水老鼠	水老鼠	水老鼠	syu lau tsy
水老鴉	水老鸦	水老鴉	syu lau o
水老菱	水老菱	水老菱	syu lau lin
水草	水草	水草	syu tshau
水溜	水溜	水溜	syu lieu
水溜管	水溜管	水溜管	syu lieu kun
水波浪	水波浪	水波浪	syu pou laon
水果	水果	水果	syu kou
水頭	水头	水頭	syu deu
水痘	水痘	水痘	syu deu
水溝	水沟	水溝	syu keu
水牛	水牛	水牛	syu ngeu
水缸	水缸	水缸	syu kaon
水缸底	水缸底	水缸底	syu kaon ti
水缸腳	水缸脚	水缸腳	syu kaon ciaq
水缸腳	水缸脚	水缸腳	syu kaon cian
水平	水平	水平	syu bin
水明湯	水明汤	水明湯	syu min thaon
水明塘	水明塘	水明塘	syu min daon
水塌窞	水塌窞	水塌窞	syu thaq dei
水窞窞	水窞窞	水窞窞	syu dei dei
水汀	水汀	水汀	syu thin
熱水汀	热水汀	熱水汀	gniq syu thin
水晶油包	水晶油包	水晶油包	syu cin yeu pau
水井	水井	水井	syu cin
水芹	水芹	水芹	syu jin
水笋	水笋	水筍	syu syun
水桶	水桶	水桶	syu don
水搨糕	水搨糕	水搨糕	syu thaq kau
水勺	水勺	水勺	syu zoq
水蜜桃	水蜜桃	水蜜桃	syu miq dau
水缺	水缺	水缺	syu chiuq
水出爛糟	水出烂糟	水出爛糟	syu tshyuq lae tsau
暑假	暑假	暑假	syu ko
如意菜	如意菜	如意菜	zyu i tshe
如話	如话	如話	zyu wo
如心像意	如心像意	如心像意	zyu shin zhian i
竪長闊短	竖长阔短	豎長闊短	zyu jian khuaq toe
竪蜻蜓	竖蜻蜓	豎蜻蜓	zyu chin din
豎屋酒	竖屋酒	豎屋酒	zyu oq cieu
聚頭	聚头	聚頭	zyu deu
聚頭	聚头	聚頭	zyu dei
聚隊	聚队	聚隊	zyu dei
誰儂	谁侬	誰儂	zyu nou
樹	树	樹	zyu6
樹幹	树干	樹幹	zyu kI
樹腦頭	树脑头	樹腦頭	zyu nau deu
樹樁	树桩	樹樁	zyu tsaon
樹丫子	树丫子	樹丫子	zyu o tsy
樹丫杈	树丫杈	樹丫杈	zyu o tsho
樹秧	树秧	樹秧	zyu ian
樹根	树根	樹根	zyu ken
樹葉爿	树叶爿	樹葉爿	zyu yiq bae
屄	屄	屄	pi1
揙	揙	揙	pi1
蝙蝠老鼠	蝙蝠老鼠	蝙蝠老鼠	pi foq lau tsy
蝙蝠	蝙蝠	蝙蝠	pi foq
篦箕	篦箕	篦箕	pi ci
鞭笋	鞭笋	鞭筍	pi syun
邊沿頭	边沿头	邊沿頭	pi yi deu
邊沿	边沿	邊沿	pi yi
邊頭	边头	邊頭	pi deu
邊旁	边旁	邊旁	pi baon
邊門	边门	邊門	pi men
扁尖	扁尖	扁尖	pi ci
扁榨榨	扁榨榨	扁榨榨	pi tso tso
扁得得	扁得得	扁得得	pi taq taq
扁擔	扁担	扁擔	pi tae
扁擔星	扁担星	扁擔星	pi tae shin
扁頭	扁头	扁頭	pi deu
扁豆	扁豆	扁豆	pi deu
扁捏豆	扁捏豆	扁捏豆	pi gniaq deu
秕子	秕子	秕子	pi tsy
鯿魚	鳊鱼	鯿魚	pi ng
變死	变死	變死	pi shi
變戲法	变戏法	變戲法	pi shi faq
變種作怪	变种作怪	變種作怪	pi tson tsoq kua
批	批	批	phi1
批花	批花	批花	phi huo
披風	披风	披風	phi fon
偏舍	偏舍	偏舍	phi so
偏頭	偏头	偏頭	phi deu
偏頭間	偏头间	偏頭間	phi deu kae
偏生	偏生	偏生	phi san
篇	篇	篇	phi1
片	片	片	phi5
屁股	屁股	屁股	phi ku
屁股翹仔	屁股翘仔	屁股翹仔	phi ku chiau tsy
屁股爿	屁股爿	屁股爿	phi ku bae
屁股溝	屁股沟	屁股溝	phi ku keu
屁眼	屁眼	屁眼	phi ngae
屁輕	屁轻	屁輕	phi chin
屁屁輕	屁屁轻	屁屁輕	phi phi chin
屁得斯輕	屁得斯轻	屁得斯輕	phi taq sy chin
屁得爛輕	屁得烂轻	屁得爛輕	phi taq lae chin
屁得爛屙輕	屁得烂屙轻	屁得爛屙輕	phi taq lae ou chin
𠜱	𠜱	𠜱	phi5
𠜱刀	𠜱刀	𠜱刀	phi tau
骗賊拐子	骗贼拐子	騙賊柺子	phi zaq kua tsy
骗子	骗子	騙子	phi tsy
譬如勿得	譬如勿得	譬如勿得	phi zyu vaq taq
譬如	譬如	譬如	phi zyu
譬如勿得	譬如勿得	譬如勿得	phi zyu vaq taq
譬如	譬如	譬如	phi zyu
皮	皮	皮	bi2
皮頓頓	皮顿顿	皮頓頓	bi ten ten
皮榨榨	皮榨榨	皮榨榨	bi tso tso
皮子麵	皮子面	皮子面	bi tsy mi
皮靴	皮靴	皮靴	bi shiu
皮大衣	皮大衣	皮大衣	bi da i
皮大王	皮大王	皮大王	bi da waon
皮鞋	皮鞋	皮鞋	bi gha
皮鞋油	皮鞋油	皮鞋油	bi gha yeu
皮包	皮包	皮包	bi pau
皮袍子	皮袍子	皮袍子	bi bau tsy
皮帽	皮帽	皮帽	bi mau
皮老虎	皮老虎	皮老虎	bi lau fu
皮襖	皮袄	皮襖	bi au
皮蛋	皮蛋	皮蛋	bi dae
皮蛋缸	皮蛋缸	皮蛋缸	bi dae kaon
皮箱	皮箱	皮箱	bi shian
皮影戲	皮影戏	皮影戲	bi in shi
皮夾	皮夹	皮夾	bi kaq
肥	肥	肥	bi2
肥皂	肥皂	肥皂	bi zau
肥皂粉	肥皂粉	肥皂粉	bi zau fen
肥料粉	肥料粉	肥料粉	bi liau fen
枇杷	枇杷	枇杷	bi bo
琵琶襟	琵琶襟	琵琶襟	bi bo cin
脾	脾	脾	bi2
蹁	蹁	蹁	bi2
蹁倒	蹁倒	蹁倒	bi tau
蹁腳	蹁脚	蹁腳	bi ciaq
坒	坒	坒	bi6
坒頭外	坒头外	坒頭外	bi deu nga
便	便	便	bi6
便田價	便田价	便田價	bi di ko
便田穀	便田谷	便田穀	bi di koq
便宜	便宜	便宜	bi gni
便條紙	便条纸	便條紙	bi diau tsy
便菜便飯	便菜便饭	便菜便飯	bi tshe bi vae
便當	便当	便當	bi taon
便客	便客	便客	bi khaq
客人	客人	客人	khaq gnin
被面	被面	被面	bi mi
被面子	被面子	被面子	bi mi tsy
被面爿	被面爿	被面爿	bi mi bae
被添	被添	被添	bi thi
被單	被单	被單	bi tae
被鋪	被铺	被鋪	bi phu
被櫃	被柜	被櫃	bi jiu
被花絮	被花絮	被花絮	bi huo shi
被窠	被窠	被窠	bi khou
被頭	被头	被頭	bi deu
被擋頭	被挡头	被擋頭	bi taon deu
被頭擋	被头挡	被頭擋	bi deu taon
被横頭	被横头	被橫頭	bi wan deu
被筒	被筒	被筒	bi don
被夾裏	被夹里	被夾裏	bi kaq li
被甩	被甩	被甩	bi huaq
被笚	被笚	被笚	bi taq
避漏	避漏	避漏	bi leu
辮子	辫子	辮子	bi tsy
辮子尾巴	辫子尾巴	辮子尾巴	bi tsy mi po
辮子尾巴	辫子尾巴	辮子尾巴	bi tsy ng po
鐾	鐾	鐾	bi6
眉眼	眉眼	眉眼	mi ngae
眉頭管	眉头管	眉頭管	mi deu kun
眉頭管蹙攏	眉头管蹙拢	眉頭管蹙攏	mi deu kun tshoq lon
眠	眠	眠	mi2
眠倒	眠倒	眠倒	mi tau
眠鼾	眠鼾	眠鼾	mi he
眠瘡	眠疮	眠瘡	mi tshaon
眠牀	眠床	眠牀	mi zaon
眠牀邊沿	眠床边沿	眠牀邊沿	mi zaon pi yi
眠牀底下	眠床底下	眠牀底下	mi zaon ti gho
眠牀下底	眠床下底	眠牀下底	mi zaon gho ti
眠牀下頭	眠床下头	眠牀下頭	mi zaon gho deu
眠牀下	眠床下	眠牀下	mi zaon gho
棉被	棉被	棉被	mi bi
棉大衣	棉大衣	棉大衣	mi da i
棉鞋	棉鞋	棉鞋	mi gha
棉毛裤	棉毛裤	棉毛褲	mi mau khu
棉毛衫	棉毛衫	棉毛衫	mi mau sae
棉桃	棉桃	棉桃	mi dau
棉襖	棉袄	棉襖	mi au
棉紗綫	棉纱线	棉紗線	mi so shi
棉瓦筒	棉瓦筒	棉瓦筒	mi ngo don
棉花	棉花	棉花	mi huo
棉花絮	棉花絮	棉花絮	mi huo shi
棉兜	棉兜	棉兜	mi teu
綿羊	绵羊	綿羊	mi yan
綿白糖	绵白糖	綿白糖	mi baq daon
彌絲彌縫	弥丝弥缝	彌絲彌縫	mi sy mi von
彌陀芥菜	弥陀芥菜	彌陀芥菜	mi dou ka tshe
彌滿	弥满	彌滿	mi mun
咪○	咪○	咪○	mhi5
咪咪	咪咪	咪咪	mhi mhi
咪咪笑	咪咪笑	咪咪笑	mhi mhi shiau
眯	眯	眯	mhi5
眯覷眼	眯觑眼	眯覷眼	mhi tshyu ngae
眯覷眼	眯觑眼	眯覷眼	mhi chi ngae
眯眯大	眯眯大	眯眯大	mhi mhi dou
眯過眼笑	眯过眼笑	眯過眼笑	mhi kou ngae shiau
𡬍花眼𥉻	𡬍花眼𥉻	𡬍花眼𥉻	mi huo ngae chi
未	未	未	mi6
米	米	米	mi4
米篩	米筛	米篩	mi sy
米字格	米字格	米字格	mi zy kaq
米蛀蟲	米蛀虫	米蛀蟲	mi tsyu dzon
米蟲	米虫	米蟲	mi dzon
米麵	米面	米麪	mi mi
米店	米店	米店	mi ti
米醋	米醋	米醋	mi tshu
米糊	米糊	米糊	mi wu
米棧房	米栈房	米棧房	mi dzae vaon
米酒	米酒	米酒	mi cieu
米甏	米甏	米甏	mi ban
米漿泔水	米浆泔水	米漿泔水	mi cian kI syu
米廠	米厂	米廠	mi chian
米胖	米胖	米胖	mi phaon
米缸	米缸	米缸	mi kaon
米行	米行	米行	mi ghaon
米饅頭	米馒头	米饅頭	mi mun deu
米囤	米囤	米囤	mi den
米飲湯	米饮汤	米飲湯	mi in thaon
米桶	米桶	米桶	mi don
米達尺	米达尺	米達尺	mi daq tshaq
米色	米色	米色	mi saq
免費學堂	免费学堂	免費學堂	mi fi ghoq daon
尾子骨	尾子骨	尾子骨	mi tsy kuaq
尾子骨	尾子骨	尾子骨	vi tsy kuaq
味道	味道	味道	mi dau
面	面	面	mi6
面刺刺	面刺刺	面刺刺	mi tshy tshy
面水	面水	面水	mi syu
面皮老	面皮老	麪皮老	mi bi lau
面面叫	面面叫	面面叫	mi mi ciau
面前	面前	面前	mi zhi
面友	面友	面友	mi yeu
面盤子	面盘子	面盤子	mi bun tsy
面架子	面架子	面架子	mi ko tsy
面登	面登	面登	mi ten
面頭登	面头登	面頭登	mi deu ten
面情	面情	面情	mi jin
面桶	面桶	面桶	mi don
面盆	面盆	面盆	mi ben
面桶架	面桶架	面桶架	mi don ko
面孔	面孔	面孔	mi khon
面頰巴	面颊巴	面頰巴	mi kaq po
面熟	面熟	面熟	mi zoq
彌海碗	弥海碗	彌海碗	mi he un
鮸魚	𩾃鱼	鮸魚	mi ng
米魚	米鱼	米魚	mi ng
麵	面	麪	mi6
麵糊	面糊	麪糊	mi wu
麵杖魚	面杖鱼	麪杖魚	mi jian ng
麵粉	面粉	麪粉	mi fen
麵粉袋	面粉袋	麪粉袋	mi fen de
麵筋	面筋	麪筋	mi cin
麵疙瘩	面疙瘩	麪疙瘩	mi kaq taq
麵食	面食	麪食	mi zhiq
飛象	飞象	飛象	fi zhian
飛相	飞相	飛相	fi shian
菲薄	菲薄	菲薄	fi boq
菲薄裏	菲薄里	菲薄裏	fi boq li
肺	肺	肺	fi5
肺炎	肺炎	肺炎	fi yi
肺家	肺家	肺家	fi ko
肺頭	肺头	肺頭	fi deu
痱子	痱子	痱子	fi tsy
痱子癗	痱子癗	痱子癗	fi tsy lei
痱子粉	痱子粉	痱子粉	fi tsy fen
未	未	未	vi6
味	味	味	vi6
味之素	味之素	味之素	vi tsy su
低	低	低	ti1
低便○	低便○	低便○	ti bi
低頭	低头	低頭	ti deu
蒂頭	蒂头	蒂頭	ti deu
點心	点心	點心	ti shin
點心	点心	點心	te shin
點心時	点心时	點心時	ti shin zy
點心時	点心时	點心時	te shin zy
點心飯	点心饭	點心飯	ti shin vae
點心飯	点心饭	點心飯	te shin vae
顛	颠	顛	ti1
顛三倒四	颠三倒四	顛三倒四	ti sae tau sy
抵配	抵配	抵配	ti phei
抵針	抵针	抵針	ti cin
底下	底下	底下	ti gho
底紅	底红	底紅	ti ghon
典主	典主	典主	ti tsyu
點	点	點	ti3
點亮	点亮	點亮	ti lian
點名	点名	點名	ti min
點名簿	点名簿	點名簿	ti min bu
店	店	店	ti5
店面	店面	店面	ti mi
店家	店家	店家	ti ko
店堂	店堂	店堂	ti daon
店堂間	店堂间	店堂間	ti daon kae
店倌	店倌	店倌	ti kun
渧	渧	渧	ti5
踮	踮	踮	ti5
踮腳	踮脚	踮腳	ti ciaq
天水	天水	天水	thi syu
天落水	天落水	天落水	thi loq syu
天妃娘娘	天妃娘娘	天妃娘娘	thi fi gnian gnian
天裏	天里	天裏	thi li
天裏菩薩	天里菩萨	天裏菩薩	thi li bu saq
天牌	天牌	天牌	thi ba
天靉攏來	天叆拢来	天靉攏來	thi a lon le
天夜	天夜	天夜	thi ya
天疱瘡	天疱疮	天皰瘡	thi phau tshaon
天價	天价	天價	thi ko
天價冷	天价冷	天價冷	thi ko lan
天價熱	天价热	天價熱	thi ko gniq
天花	天花	天花	thi huo
出天花	出天花	出天花	tshyuq thi huo
天花板	天花板	天花板	thi huo pae
天菜	天菜	天菜	thi tshe
天菜蕻	天菜蕻	天菜蕻	thi tshe hon
天菜心	天菜心	天菜心	thi tshe shin
天開眼	天开眼	天開眼	thi khe ngae
天膽地大	天胆地大	天膽地大	thi tae di dou
天藍	天蓝	天藍	thi lae
天旱	天旱	天旱	thi ghEI
天蘿	天萝	天蘿	thi lou
天蘿箲	天萝箲	天蘿箲	thi lou shi
天蘿花箲	天萝花箲	天蘿花箲	thi lou huo shi
天河	天河	天河	thi ghou
天狗喫日頭	天狗吃日头	天狗吃日頭	thi keu chioq gniq deu
天狗拖日頭	天狗拖日头	天狗拖日頭	thi keu thou gniq deu
天狗拖日頭	天狗拖日头	天狗拖日頭	thi keu tha gniq deu
天狗喫月亮	天狗吃月亮	天狗吃月亮	thi keu chioq yuq lian
天狗拖月亮	天狗拖月亮	天狗拖月亮	thi keu thou yuq lian
天狗拖月亮	天狗拖月亮	天狗拖月亮	thi keu tha yuq lian
天打煞	天打煞	天打煞	thi tan saq
天窗	天窗	天窗	thi tshaon
天平	天平	天平	thi bin
天平秤	天平秤	天平秤	thi bin chin
天庭	天庭	天庭	thi din
天井	天井	天井	thi cin
天心	天心	天心	thi shin
天童寺	天童寺	天童寺	thi don zy
天日	天日	天日	thi gniq
天一閣	天一阁	天一閣	thi iq koq
添	添	添	thi1
添裏布衫	添里布衫	添裏布衫	thi li pu sae
添裏褲	添里裤	添裏褲	thi li khu
掭筆	掭笔	掭筆	thi piq
舔	舔	舔	thi3
體○體○汰○汰○	体○体○汰○汰○	體○體○汰○汰○	thi thi tha tha
體○裏汰○剌	体○里汰○剌	體○裏汰○剌	thi li tha la
體○汰○	体○汰○	體○汰○	thi tha
體○汰○婆	体○汰○婆	體○汰○婆	thi tha bou
體○汰○阿姆	体○汰○阿姆	體○汰○阿姆	thi tha an m
體拓	体拓	體拓	thi thoq
䪆	䪆	䪆	thi5
䪆潔	䪆洁	䪆潔	thi ciq
剃牙鬚	剃牙须	剃牙鬚	thi ngo su
剃頭	剃头	剃頭	thi deu
剃頭店	剃头店	剃頭店	thi deu ti
剃頭剪刀	剃头剪刀	剃頭剪刀	thi deu ci tau
剃頭椅子	剃头椅子	剃頭椅子	thi deu i tsy
剃頭椅子	剃头椅子	剃頭椅子	thi deu iu tsy
剃頭椅子	剃头椅子	剃頭椅子	thi deu u tsy
剃頭刀	剃头刀	剃頭刀	thi deu tau
剃頭擔	剃头担	剃頭擔	thi deu tae
剃頭郎	剃头郎	剃頭郎	thi deu laon
剃頭師父	剃头师父	剃頭師父	thi deu sy vu
替手	替手	替手	thi shieu
田	田	田	di2
田鼠	田鼠	田鼠	di tshyu
田老蟲	田老虫	田老蟲	di lau dzon
田鷄	田鸡	田雞	di ci
田畈	田畈	田畈	di pae
畈	畈	畈	pae3
田墈	田墈	田墈	di khae
田螺	田螺	田螺	di lou
田螺眼	田螺眼	田螺眼	di lou ngae
田螺欶	田螺欶	田螺欶	di lou soq
田頭	田头	田頭	di deu
田横頭	田横头	田橫頭	di wan deu
田塍	田塍	田塍	di yin
田蠢	田蠢	田蠢	di tshyun
甜	甜	甜	di2
甜味醬	甜味酱	甜味醬	di mi cian
甜頭	甜头	甜頭	di deu
甜口	甜口	甜口	di kheu
甜羹	甜羹	甜羹	di kan
甜漿漿	甜浆浆	甜漿漿	di cian cian
甜嫩頭	甜嫩头	甜嫩頭	di nen deu
甜嫩嫩	甜嫩嫩	甜嫩嫩	di nen nen
甜咪咪	甜咪咪	甜咪咪	di mhi mhi
甜津津	甜津津	甜津津	di cin cin
甜食	甜食	甜食	di zhiq
堤	堤	堤	di2
提子	提子	提子	di tsy
提簍	提篓	提簍	di leu
提桶	提桶	提桶	di don
填房	填房	填房	di vaon
意○房	意○房	意○房	i vaon
蹄髈	蹄髈	蹄髈	di phaon
蹄筋	蹄筋	蹄筋	di cin
鯷魚	鳀鱼	鯷魚	di ng
地	地	地	di6
地主阿太	地主阿太	地主阿太	di tsyu aq tha
地皮	地皮	地皮	di bi
地基石	地基石	地基石	di ci zaq
地契	地契	地契	di chi
地租	地租	地租	di tsu
地園	地园	地園	di yu
地牌	地牌	地牌	di ba
地竈	地灶	地竈	di tsau
地板	地板	地板	di pae
地毯	地毯	地毯	di thae
地磚	地砖	地磚	di tsoe
地頭鬼	地头鬼	地頭鬼	di deu ciu
地頭蛇	地头蛇	地頭蛇	di deu dzo
地溝	地沟	地溝	di keu
地狗	地狗	地狗	di keu
地樣	地样	地樣	di yan
地壤	地壤	地壤	di gnian
地樣裏	地样里	地樣裏	di yan li
地壤裏	地壤里	地壤裏	di gnian li
地樣下頭	地样下头	地樣下頭	di gnian gho deu
地壤下頭	地壤下头	地壤下頭	di gnian gho deu
地樣下底	地样下底	地樣下底	di yan gho ti
地壤下底	地壤下底	地壤下底	di gnian gho ti
地方	地方	地方	di faon
地藏王菩薩	地藏王菩萨	地藏王菩薩	di dzaon waon bu saq
地㽘	地㽘	地㽘	di gaon
地坪	地坪	地坪	di bin
地腳印	地脚印	地腳印	di ciaq in
地袱	地袱	地袱	di boq
地袱踏穿	地袱踏穿	地袱踏穿	di boq daq tshOE
地袱𨂝穿	地袱𨂝穿	地袱𨂝穿	di boq bae tshOE
地作貨	地作货	地作貨	di tsoq hou
地鱉蟲	地鳖虫	地鱉蟲	di piq dzon
地栗	地栗	地栗	di liq
地栗糕	地栗糕	地栗糕	di liq kau
地軸	地轴	地軸	di jiuq
弟弟	弟弟	弟弟	di di
弟新婦	弟新妇	弟新婦	di shin vu
第	第	第	di6
第二天亮	第二天亮	第二天亮	di gni thiq gnian
第二日	第二日	第二日	di gni gniq
電綫木頭	电线木头	電線木頭	di shi moq deu
電綫杆子	电线杆子	電線杆子	di shi kI tsy
電光燈	电光灯	電光燈	di kuaon ten
電燈貓	电灯猫	電燈貓	di ten mae
電工猫	电工猫	電工貓	di kon mae
鈿	钿	鈿	di6
銅鈿銀子	铜钿银子	銅鈿銀子	don di gnin tsy
墊被	垫被	墊被	di bi
墊被套	垫被套	墊被套	di bi thau
墊肩	垫肩	墊肩	di ci
墊板	垫板	墊板	di pae
墊腳石	垫脚石	墊腳石	di ciaq zaq
簟匠	簟匠	簟匠	di zhian
連底凍	连底冻	連底凍	li ti ton
連兼	连兼	連兼	li ci
連爹連娘	连爹连娘	連爹連娘	li tia li gnian
賣爹賣娘	卖爹卖娘	賣爹賣娘	ma tia ma gnian
連刀塊	连刀块	連刀塊	li tau khuei
連牢	连牢	連牢	li lau
連衫裙	连衫裙	連衫裙	li sae jiun
連衫連裙	连衫连裙	連衫連裙	li sae li jiun
連衫連褲	连衫连裤	連衫連褲	li sae li khu
連坐	连坐	連坐	li zou
連頭搭腦	连头搭脑	連頭搭腦	li deu taq nau
連襠碼子	连裆码子	連襠碼子	li taon mo tsy
連襟	连襟	連襟	li cin
梨頭	梨头	梨頭	li deu
犁	犁	犁	li2
犁鑱頭	犁镵头	犁鑱頭	li zae deu
犁鑱蝮	犁镵蝮	犁鑱蝮	li zae phoq
犁柄	犁柄	犁柄	li pin
犁梢尾巴	犁梢尾巴	犁梢尾巴	li sau mi po
犁梢尾巴	犁梢尾巴	犁梢尾巴	li sau ng po
犁沖○	犁冲○	犁衝○	li tshon
犁身	犁身	犁身	li shin
蓮子調羹	莲子调羹	蓮子調羹	li tsy diau kan
蓮子飯碗	莲子饭碗	蓮子飯碗	li tsy vae un
蓮花文書	莲花文书	蓮花文書	li huo ven syu
蓮心	莲心	蓮心	li shin
蓮蓬	莲蓬	蓮蓬	li bon
蓮蓬頭	莲蓬头	蓮蓬頭	li bon deu
離○	离○	離○	li2
離星	离星	離星	li shin
離婚	离婚	離婚	li huen
離縫	离缝	離縫	li von
鐮刀	镰刀	鐮刀	li tau
謰謰謱謱	謰謰𫍴𫍴	謰謰謱謱	lhi lhi lho lho
李子	李子	李子	li tsy
里把路	里把路	里把路	li po lu
利市	利市	利市	li zy
利鈿	利钿	利鈿	li di
利朗	利朗	利朗	li laon
荔枝	荔枝	荔枝	li ci
旅	旅	旅	li6
旅社	旅社	旅社	li dzo
旅游鞋	旅游鞋	旅遊鞋	li yeu gha
痢疾⿸尸查	痢疾⿸尸查	痢疾⿸尸查	li jiq dza
摙	摙	摙	li4
楝樹	楝树	楝樹	li zyu
㪝槌	㪝槌	㪝槌	li dzyu
裏	里	裏	li4
裏山	里山	裏山	li sae
裏間	里间	裏間	li kae
裏紐	里纽	裏紐	li gnieu
裏廂	里厢	裏廂	li shian
裏頭	里头	裏頭	li deu
裏角落頭	里角落头	裏角落頭	li koq loq deu
裏脊肉	里脊肉	裏脊肉	li ciq gnioq
㪝	㪝	㪝	li6
厲○	厉○	厲○	li6
練出	练出	練出	li tshyuq
禮拜	礼拜	禮拜	li pa
禮拜堂	礼拜堂	禮拜堂	li pa daon
斂	敛	斂	li4
鯉魚	鲤鱼	鯉魚	li ng
鏈條	链条	鏈條	li diau
蠣黄	蛎黄	蠣黃	li waon
蠣黄跑蛋	蛎黄跑蛋	蠣黃跑蛋	li waon bau dae
𪚁	𪚁	𪚁	li6
肌身火熱	肌身火热	肌身火熱	ci shin hou gniq
肌身涾涾滾	肌身涾涾滚	肌身涾涾滾	ci shin daq daq kuen
肌身熱	肌身热	肌身熱	ci shin gniq
發寒熱	发寒热	發寒熱	faq ghEI gniq
尖	尖	尖	ci1
尖利	尖利	尖利	ci li
尖頭辣椒	尖头辣椒	尖頭辣椒	ci deu laq ciau
尖角領	尖角领	尖角領	ci koq lin
肩胛頭	肩胛头	肩胛頭	ci kaq deu
肩胛	肩胛	肩胛	ci kaq
煎藥	煎药	煎藥	ci yaq
箕	箕	箕	ci1
嘰嘟	叽嘟	嘰嘟	ci tu
機器腳踏車	机器脚踏车	機器腳踏車	ci chi ciaq daq tsho
摩托車	摩托车	摩托車	moq thoq tsho
機耕路	机耕路	機耕路	ci kan lu
氈鞋	毡鞋	氈鞋	ci gha
己	己	己	ci3
姊妹	姊妹	姊妹	ci mei
姊妹道裏	姊妹道里	姊妹道裏	ci mei dau li
姊妹家	姊妹家	姊妹家	ci mei ko
剪刀	剪刀	剪刀	ci tau
剪刀破絹帕	剪刀破绢帕	剪刀破絹帕	ci tau phou ciu phae
幾	几	幾	ci3
幾糟	几糟	幾糟	ci tsau
幾個	几个	幾個	ci goq
幾個	几个	幾個	ci kou
蟣仔	虮仔	蟣仔	ci tsy
鷄	鸡	雞	ci3
鷄鷄狗狗	鸡鸡狗狗	雞雞狗狗	ci ci keu keu
鷄狗鷄狗	鸡狗鸡狗	雞狗雞狗	ci keu ci keu
鷄院	鸡院	雞院	ci yu
鷄毛菜	鸡毛菜	雞毛菜	ci mau tshe
鷄毛撣帚	鸡毛掸帚	雞毛撣帚	ci mau tae cieu
鷄毛刷帚	鸡毛刷帚	雞毛刷帚	ci mau syuq cieu
鷄爪風	鸡爪风	雞爪風	ci tsau fon
鷄罩	鸡罩	雞罩	ci tsau
鷄麻則陋	鸡麻则陋	雞麻則陋	ci mo tsaq leu
鷄蛋	鸡蛋	雞蛋	ci dae
鷄眼	鸡眼	雞眼	ci ngae
鷄娘	鸡娘	雞娘	ci gnian
鷄冠花	鸡冠花	雞冠花	ci kun huo
鷄冠頭	鸡冠头	雞冠頭	ci kun deu
鷄瞪鼓	鸡瞪鼓	雞瞪鼓	ci ten ku
鷄肫	鸡肫	雞肫	ci tsyun
鷄肫皮	鸡肫皮	雞肫皮	ci tsyun bi
鷄籠	鸡笼	雞籠	ci lon
鷄雜	鸡杂	雞雜	ci dzaq
鷄○眨○覺	鸡○眨○觉	雞○眨○覺	ci saq kau
鷄腳爪	鸡脚爪	雞腳爪	ci ciaq tsau
鷄血	鸡血	雞血	ci shiuq
占擺	占摆	佔擺	ci pa
占相因	占相因	佔相因	ci shian in
見面鈿	见面钿	見面鈿	ci mi di
見大頭鬼	见大头鬼	見大頭鬼	ci dou deu ciu
見䏘鬼	见䏘鬼	見䏘鬼	ci phiq ciu
計高○	计高○	計高○	ci kau
既	既	既	ci5
牮	牮	牮	ci5
牮屋	牮屋	牮屋	ci oq
記	记	記	ci5
記牢	记牢	記牢	ci lau
記掛	记挂	記掛	ci kuo
記防	记防	記防	ci baon
記情	记情	記情	ci jin
記認	记认	記認	ci gnin
記性	记性	記性	ci shin
記得	记得	記得	ci taq
記錄簿	记录簿	記錄簿	ci loq bu
祭竈果	祭灶果	祭竈果	ci tsau kou
寄○手勿動	寄○手勿动	寄○手勿動	ci shieu vaq don
𣥼飯	𣥼饭	𣥼飯	ci vae
薦頭人	荐头人	薦頭人	ci deu gnin
繫	系	繫	ci5
繼拜	继拜	繼拜	ci pa
繼拜囡	继拜囡	繼拜囡	ci pa noe
繼拜阿娘	继拜阿娘	繼拜阿孃	ci pa aq gnian
繼拜阿爹	继拜阿爹	繼拜阿爹	ci pa aq tia
繼拜兒子	继拜儿子	繼拜兒子	ci pa ng tsy
千變萬化	千变万化	千變萬化	chi pi vae huo
千言萬語	千言万语	千言萬語	chi yi vae gniu
千家萬户	千家万户	千家萬戶	chi ko vae wu
千把人	千把人	千把人	chi po gnin
千把個	千把个	千把個	chi po goq
千把個	千把个	千把個	chi po kou
千錯萬錯	千错万错	千錯萬錯	chi tshou vae tshou
千層	千层	千層	chi zen
千層餅	千层饼	千層餅	chi zen pin
千定萬定	千定万定	千定萬定	chi din vae din
千真萬確	千真万确	千真萬確	chi cin vae chiuq
千針萬針	千针万针	千針萬針	chi cin vae cin
千辛萬苦	千辛万苦	千辛萬苦	chi shin vae khu
千軍萬馬	千军万马	千軍萬馬	chi ciun vae mo
棲蟲	栖虫	棲蟲	chi dzon
牽絲𢲔凳	牵丝𢲔凳	牽絲𢲔凳	chi sy pae ten
牽扯	牵扯	牽扯	chi tsha
牽扯阿姆	牵扯阿姆	牽扯阿姆	chi tsha an m
牽磨	牵磨	牽磨	chi mou
牽頭皮	牵头皮	牽頭皮	chi deu bi
牽牛鼻頭	牵牛鼻头	牽牛鼻頭	chi ngeu baq deu
牽礱	牵砻	牽礱	chi lon
欺軟怕惡	欺软怕恶	欺軟怕惡	chi gniu pho oq
溪翹	溪翘	溪翹	chi chiau
溪口鎮	溪口镇	溪口鎮	chi kheu tsyun
溪坑	溪坑	溪坑	chi khan
溪坑水	溪坑水	溪坑水	chi khan syu
遷	迁	遷	chi1
遷就	迁就	遷就	chi jieu
槧	椠	槧	chi1
槧腳	椠脚	槧腳	chi ciaq
簽筒	签筒	籤筒	chi don
縴杠	纤杠	縴槓	chi kaon
縴繩	纤绳	縴繩	chi zhin
杞子腦	杞子脑	杞子腦	chi tsy nau
起	起	起	chi3
起鷄皮疙瘩	起鸡皮疙瘩	起雞皮疙瘩	chi ci bi kaq taq
起早落夜	起早落夜	起早落夜	chi tsau loq ya
起燥	起燥	起燥	chi sau
起畈	起畈	起畈	chi pae
耕頭番	耕头番	耕頭番	kan deu fae
耕貳番	耕贰番	耕貳番	kan gni fae
起九	起九	起九	chi cieu
起頭	起头	起頭	chi deu
起風	起风	起風	chi fon
起腳	起脚	起腳	chi ciaq
起屋	起屋	起屋	chi oq
淺	浅	淺	chi3
淺鬆鬆	浅松松	淺鬆鬆	chi son son
淺索索	浅索索	淺索索	chi soq soq
欠	欠	欠	chi5
欠夠	欠够	欠夠	chi keu
汽水	汽水	汽水	chi syu
荷蘭水	荷兰水	荷蘭水	ghou lae syu
汽車	汽车	汽車	chi tsho
汽車夫	汽车夫	汽車伕	chi tsho fu
汽車路	汽车路	汽車路	chi tsho lu
公路	公路	公路	kon lu
汽油	汽油	汽油	chi yeu
汽油燈	汽油灯	汽油燈	chi yeu ten
氣	气	氣	chi5
氣味	气味	氣味	chi mi
氣數	气数	氣數	chi su
氣胎	气胎	氣胎	chi the
氣概	气概	氣概	chi ke
氣耐勿牢	气耐勿牢	氣耐勿牢	chi ne vaq lau
氣量	气量	氣量	chi lian
氣窗	气窗	氣窗	chi tshaon
氣門絶煞	气门绝煞	氣門絕煞	chi men dzyuq saq
氣悶	气闷	氣悶	chi mhen
氣緊	气紧	氣緊	chi cin
氣勿過	气勿过	氣勿過	chi vaq kou
氣勒過	气勒过	氣勒過	chi laq kou
氣煞	气煞	氣煞	chi saq
氣血	气血	氣血	chi shiuq
池塘	池塘	池塘	ji daon
奇奇	奇奇	奇奇	ji ji
奇出古怪	奇出古怪	奇出古怪	ji tshyuq ku kua
敧	敧	敧	ji2
齊巧	齐巧	齊巧	ji chiau
旗袍	旗袍	旗袍	ji bau
旗袍裙	旗袍裙	旗袍裙	ji bau jiun
遲早點	迟早点	遲早點	ji tsau ti
遲發人	迟发人	遲發人	ji faq gnin
錢莊	钱庄	錢莊	ji tsaon
薺菜	荠菜	薺菜	ji tshe
臍帶風	脐带风	臍帶風	ji ta fon
纏	缠	纏	ji2
鰭槍	鳍枪	鰭槍	ji chian
鱭魚	鲚鱼	鱭魚	ji ng
件	件	件	ji4
𢺵	𢺵	𢺵	ji6
𢺵歪	𢺵歪	𢺵歪	ji hua
𢺵笡	𢺵笡	𢺵笡	ji chia
𢺵頭	𢺵头	𢺵頭	ji deu
歧頭鵝	歧头鹅	歧頭鵝	ji deu ngou
忌嘴	忌嘴	忌嘴	ji tsyu
忌日羹飯	忌日羹饭	忌日羹飯	ji gniq kan vae
忮	忮	忮	ji6
苧麻	苎麻	苧麻	ji mo
健	健	健	ji6
健健個	健健个	健健個	ji ji kou
渠	渠	渠	ji6
渠儂	渠侬	渠儂	ji nou
渠個	渠个	渠個	ji goq
渠儂個	渠侬个	渠儂個	ji nou goq
痔漏	痔漏	痔漏	ji leu
痔瘡	痔疮	痔瘡	ji tshaon
掮客	掮客	掮客	ji khaq
廐	厩	廄	ji6
黏牢	黏牢	黏牢	kni lau
黏膠膠	黏胶胶	黏膠膠	kni kau kau
黏格格	黏格格	黏格格	kni kaq kaq
黏得得	黏得得	黏得得	kni taq taq
黏結格牢	黏结格牢	黏結格牢	kni ciq kaq lau
尼姑	尼姑	尼姑	gni ku
尼姑庵	尼姑庵	尼姑庵	gni ku EI
庵堂	庵堂	庵堂	EI daon
年底	年底	年底	gni ti
年紀	年纪	年紀	gni ci
年年	年年	年年	gni gni
每年	每年	每年	mei gni
年初	年初	年初	gni tshu
年初一	年初一	年初一	gni tshu iq
年數	年数	年數	gni su
年夜頭	年夜头	年夜頭	gni ya deu
年三十邊	年三十边	年三十邊	gni sae zyuq pi
年夜三十邊	年夜三十边	年夜三十邊	gni ya sae zyuq pi
年夜三邊	年夜三边	年夜三邊	gni ya sae pi
年糕	年糕	年糕	gni kau
年糕片	年糕片	年糕片	gni kau phi
年糕糰	年糕团	年糕糰	gni kau doe
年三十夜	年三十夜	年三十夜	gni sae zyuq ya
年三十夜	年三十夜	年三十夜	gni sae syuq ya
年貨	年货	年貨	gni hou
年口	年口	年口	gni kheu
年庚	年庚	年庚	gni kan
年份	年份	年份	gni ven
年成	年成	年成	gni jin
呢	呢	呢	gni2
泥	泥	泥	gni2
泥猪	泥猪	泥豬	gni tsyu
泥水	泥水	泥水	gni syu
泥刀	泥刀	泥刀	gni tau
泥蛇	泥蛇	泥蛇	gni dzo
泥板	泥板	泥板	gni pae
泥墁板	泥墁板	泥墁板	gni mun pae
泥鰍	泥鳅	泥鰍	gni chieu
泥銹	泥锈	泥鏽	gni shieu
泥坯	泥坯	泥坯	gni phei
泥螺	泥螺	泥螺	gni lou
泥墁	泥墁	泥墁	gni mun
泥夾	泥夹	泥夾	gni kaq
泥壁	泥壁	泥壁	gni piq
宜○胡正經	宜○胡正经	宜○胡正經	gni wu cin cin
埿	埿	埿	gni2
疑心	疑心	疑心	gni shin
疑心疑惑	疑心疑惑	疑心疑惑	gni shin gni ghoq
疑惑勿決	疑惑勿决	疑惑勿決	gni ghoq vaq ciuq
閻羅大王	阎罗大王	閻羅大王	gni lou da waon
黏黏上	黏黏上	黏黏上	gni gni zaon
黏頭樹	黏头树	黏頭樹	gni deu zyu
二	二	二	gni6
二處飯	二处饭	二處飯	gni tshyu vae
二房東	二房东	二房東	gni vaon ton
二婚頭	二婚头	二婚頭	gni huen deu
二阿哥	二阿哥	二阿哥	gni aq kou
二伏	二伏	二伏	gni voq
二汁	二汁	二汁	gni ciq
二十邊	二十边	二十邊	gni zyuq pi
二五八六	二五八六	二五八六	gni ng paq loq
二五打八六	二五打八六	二五打八六	gni ng tan paq loq
耳朵套	耳朵套	耳朵套	gni to thau
耳朵套	耳朵套	耳朵套	ng to thau
耳朵弯	耳朵弯	耳朵彎	gni to uae
耳朵弯	耳朵弯	耳朵彎	ng to uae
黏饞	黏馋	黏饞	gni zae
染坊	染坊	染坊	gni faon
研船	研船	研船	gni zOE
硯瓦爿	砚瓦爿	硯瓦爿	gni ngoq bae
硯墨爿	砚墨爿	硯墨爿	gni moq bae
碾子	碾子	碾子	gni tsy
腻腥	腻腥	膩腥	gni shin
腻腥不剌	腻腥不剌	膩腥不剌	gni shin paq laq
仙人	仙人	仙人	shi gnin
仙人球	仙人球	仙人球	shi gnin jieu
仙人掌	仙人掌	仙人掌	shi gnin tsaon
西湖楊柳	西湖杨柳	西湖楊柳	shi wu yan lieu
西瓜	西瓜	西瓜	shi kuo
西瓜時	西瓜时	西瓜時	shi kuo zy
西瓜帽頭	西瓜帽头	西瓜帽頭	shi kuo mau deu
西瓜蟲	西瓜虫	西瓜蟲	shi kuo dzon
西瓜頭蟲	西瓜头虫	西瓜頭蟲	shi kuo deu dzon
西崽	西崽	西崽	shi tse
西裝	西装	西裝	shi tsaon
西裝短褲	西装短裤	西裝短褲	shi tsaon toe khu
西半邊	西半边	西半邊	shi pun pi
西面	西面	西面	shi mi
西○枕頭	西○枕头	西○枕頭	shi cin deu
西○枕頭心	西○枕头心	西○枕頭心	shi cin deu shin
先	先	先	shi1
先生	先生	先生	shi san
希○	希○	希○	shi1
希○裏吼○漏	希○里吼○漏	希○裏吼○漏	shi li heu leu
希○吼○	希○吼○	希○吼○	shi heu
軒轎	轩轿	軒轎	shi jiau
稀裏糊塗	稀里糊涂	稀裏糊塗	shi li wu du
稀稀	稀稀	稀稀	shi shi
稀稀浪○浪○	稀稀浪○浪○	稀稀浪○浪○	shi shi laon laon
稀索	稀索	稀索	shi soq
嬉	嬉	嬉	shi1
嬉䏘	嬉䏘	嬉䏘	shi phiq
鮮	鲜	鮮	shi1
鮮☐☐	鲜☐☐	鮮☐☐	shi do do
鮮眼氣	鲜眼气	鮮眼氣	shi ngae chi
鮮爽	鲜爽	鮮爽	shi saon
鮮白壘○魚	鲜白垒○鱼	鮮白壘○魚	shi baq lei ng
鮮辣粉	鲜辣粉	鮮辣粉	shi laq fen
箲帚	箲帚	箲帚	shi cieu
死	死	死	shi3
死蟹一隻	死蟹一只	死蟹一隻	shi ha iq tsaq
死掉	死掉	死掉	shi diau
死話	死话	死話	shi wo
死腔	死腔	死腔	shi chian
死樣	死样	死樣	shi yan
死樣怪氣	死样怪气	死樣怪氣	shi yan kua chi
死藤南瓜	死藤南瓜	死藤南瓜	shi den nEI kuo
死藤	死藤	死藤	shi den
死進死出	死进死出	死進死出	shi cin shi tshyuq
死人	死人	死人	shi gnin
死坯	死坯	死坯	shi phei
死人勿怪	死人勿怪	死人勿怪	shi gnin vaq kua
死結	死结	死結	shi ciq
閃腰	闪腰	閃腰	shi iau
閃龍光閃	闪龙光闪	閃龍光閃	shi lon kuaon shi
喜果	喜果	喜果	shi kou
喜糖	喜糖	喜糖	shi daon
癬	癣	癬	shi3
扇	扇	扇	shi5
扇子	扇子	扇子	shi tsy
細味醬	细味酱	細味醬	shi mi cian
細鹽	细盐	細鹽	shi yi
細巧	细巧	細巧	shi chiau
細碎	细碎	細碎	shi sei
細倭豆	细倭豆	細倭豆	shi ou deu
細相	细相	細相	shi shian
細糠	细糠	細糠	shi khaon
細粉	细粉	細粉	shi fen
搧巴掌	搧巴掌	搧巴掌	shi po tsaon
綫毯	线毯	線毯	shi thae
綫春	线春	線春	shi tshyun
綫襪	线袜	線襪	shi maq
綫腳	线脚	線腳	shi ciaq
戲子人	戏子人	戲子人	shi tsy gnin
戲子	戏子	戲子	shi tsy
戲票	戏票	戲票	shi phiau
戲臺	戏台	戲臺	shi de
戲館	戏馆	戲館	shi kun
戲文	戏文	戲文	shi ven
戲文人	戏文人	戲文人	shi ven gnin
騸鷄	骟鸡	騸雞	shi ci
骟馬	骟马	騸馬	shi mo
前年子	前年子	前年子	zhi gni tsy
前年	前年	前年	zhi gni
前駝背	前驼背	前駝背	zhi dou pei
前個月	前个月	前個月	zhi kou yuq
前個月	前个月	前個月	zhi goq yuq
前頭	前头	前頭	zhi deu
前生前世	前生前世	前生前世	zhi san zhi shi
前梁頭	前梁头	前樑頭	zhi lian deu
前兩年	前两年	前兩年	zhi lian gni
前幾年	前几年	前幾年	zhi ci gni
前兩日	前两日	前兩日	zhi lian gniq
前槍○	前枪○	前槍○	zhi chian
前一槍○	前一枪○	前一槍○	zhi iq chian
前夾身	前夹身	前夾身	zhi kaq shin
前腳後跟	前脚后跟	前腳後跟	zhi ciaq gheu ken
前日子	前日子	前日子	zhi gniq tsy
前日	前日	前日	zhi gniq
齊	齐	齊	zhi2
自道自撑	自道自撑	自道自撐	zhi dau zhi tshan
自造腔	自造腔	自造腔	zhi zau chian
自家	自家	自家	zhi ko
自家人	自家人	自家人	zhi ko gnin
賤骨頭	贱骨头	賤骨頭	zhi kuaq deu
甘蔗	甘蔗	甘蔗	kI tso
甘○人家	甘○人家	甘○人家	kI gnin ko
肝	肝	肝	kI1
肝炎	肝炎	肝炎	kI yi
泔腳	泔脚	泔腳	kI ciaq
泔腳缸	泔脚缸	泔腳缸	kI ciaq kaon
乾菜	干菜	乾菜	kI tshe
乾貝	干贝	乾貝	kI pei
乾果	干果	乾果	kI kou
乾薑癟棗	干姜瘪枣	乾薑癟棗	kI cian piq tsau
乾剝剝	干剥剥	乾剝剝	kI poq poq
該應	该应	該應	kI in
鋸	锯	鋸	kI1
鋸路	锯路	鋸路	kI lu
鋸屑	锯屑	鋸屑	kI shiq
鋸屑板	锯屑板	鋸屑板	kI shiq pae
感冒	感冒	感冒	kI mau
趕水	赶水	趕水	kI syu
趕出去	赶出去	趕出去	kI tshyuq chi
看	看	看	khI5
看見生情	看见生情	看見生情	khI ci san jin
看醫生	看医生	看醫生	khI i san
看護	看护	看護	khI wu
看翻	看翻	看翻	khI fae
看鴨船	看鸭船	看鴨船	khI ae zOE
看頭	看头	看頭	khI deu
看牛頑	看牛顽	看牛頑	khI ngeu uae
看牛小頑	看牛小顽	看牛小頑	khI ngeu shiau uae
看張	看张	看張	khI cian
看相	看相	看相	khI shian
看相先生	看相先生	看相先生	khI shian shi san
看樣子	看样子	看樣子	khI yan tsy
看風使船	看风使船	看風使船	khI fon sy zOE
看風水	看风水	看風水	khI fon syu
看中意	看中意	看中意	khI tson i
看白戲	看白戏	看白戲	khI baq shi
看勿起	看勿起	看勿起	khI vaq chi
看勒起	看勒起	看勒起	khI laq chi
看的	看的	看的	khI tiq
看眼的	看眼的	看眼的	khI ngae tiq
延	延	延	yi2
延笆豆	延笆豆	延笆豆	yi po deu
迤風斜雨	迤风斜雨	迤風斜雨	yi fon zhia yu
沿○	沿○	沿○	yi2
沿	沿	沿	yi2
沿邊芋艿	沿边芋艿	沿邊芋艿	yi pi n na
沿街	沿街	沿街	yi ka
沿鞋	沿鞋	沿鞋	yi gha
沿鞋口	沿鞋口	沿鞋口	yi gha kheu
姨嬷	姨嬷	姨嬤	yi mho
姨嬷頭	姨嬷头	姨嬤頭	yi mho deu
姨婆	姨婆	姨婆	yi bou
姨丈	姨丈	姨丈	yi jian
姨丈公	姨丈公	姨丈公	yi jian kon
移○	移○	移○	yi2
移	移	移	yi2
蜒蚰螺	蜒蚰螺	蜒蚰螺	yi yi lou
蜒螺	蜒螺	蜒螺	yi lou
肄業	肄业	肄業	yi gniq
痬	痬	痬	yi2
遗腹子	遗腹子	遺腹子	yi foq tsy
𧍢	𧍢	𧍢	yi2
檐頭水	檐头水	檐頭水	yi deu syu
檐楯	檐楯	檐楯	yi zyun
檐楯口	檐楯口	檐楯口	yi zyun kheu
鹽	盐	鹽	yi2
鹽水	盐水	鹽水	yi syu
鹽水蝦	盐水虾	鹽水蝦	yi syu huo
鹽茄糊	盐茄糊	鹽茄糊	yi jia wu
鹽花	盐花	鹽花	yi huo
鹽甏	盐甏	鹽甏	yi ban
鹽白菜	盐白菜	鹽白菜	yi baq tshe
以…	以…	以…	yi4
以上	以上	以上	yi zaon
以下	以下	以下	yi gho
異樣	异样	異樣	yi yan
異樣刮得	异样刮得	異樣刮得	yi yan kuaq taq
現	现	現	yi6
現世報	现世报	現世報	yi syu pau
現○現○動	现○现○动	現○現○動	yi yi don
現○湯	现○汤	現○湯	yi thaon
現鈔	现钞	現鈔	yi tshau
勩	勚	勩	yi6
衣	衣	衣	i1
衣架	衣架	衣架	i ko
衣衫	衣衫	衣衫	i sae
衣莊	衣庄	衣莊	i tsaon
衣裳	衣裳	衣裳	i zaon
依	依	依	i1
依	依	依	i1
依稀	依稀	依稀	i shi
依依名	依依名	依依名	i i min
依路	依路	依路	i lu
依掉	依掉	依掉	i diau
依心依相	依心依相	依心依相	i shin i shian
依心相	依心相	依心相	i shin shian
依心滿足	依心满足	依心滿足	i shin mun tsoq
胭脂	胭脂	胭脂	i ci
胭脂紅	胭脂红	胭脂紅	i ci ghon
煙	烟	煙	i1
煙	烟	菸	i1
煙紙店	烟纸店	菸紙店	i tsy ti
煙絲	烟丝	菸絲	i sy
煙袋袋	烟袋袋	菸袋袋	i de de
煙油	烟油	菸油	i yeu
煙灰	烟灰	菸灰	i huei
煙火氣	烟火气	煙火氣	i hou chi
煙囱	烟囱	煙囪	i tshon
煙盒子	烟盒子	菸盒子	i ghaq tsy
煙灼辣辣	烟灼辣辣	煙灼辣辣	i ciq laq laq
煙葉	烟叶	菸葉	i yiq
嫌貶	嫌贬	嫌貶	i pi
嫌憎	嫌憎	嫌憎	i tsen
蔫	蔫	蔫	i1
蔫糟糟	蔫糟糟	蔫糟糟	i tsau tsau
蔫樣黄	蔫样黄	蔫樣黃	i yan waon
腌篤鮮	腌笃鲜	醃篤鮮	i toq shi
瞖	瞖	瞖	i1
醫	医	醫	i1
醫生	医生	醫生	i san
掩板	掩板	掩板	i pae
掩思○板	掩思○板	掩思○板	i sy pae
咽酸	咽酸	咽酸	i soe
意○	意○	意○	i5
意基○	意基○	意基○	i ci
意外	意外	意外	i nga
意○房	意○房	意○房	i vaon
厭糟糟	厌糟糟	厭糟糟	i tsau tsau
䞁	䞁	䞁	i5
燕子	燕子	燕子	i tsy
燕子領	燕子领	燕子領	i tsy lin
燕青	燕青	燕青	i chin
補破衣裳	补破衣裳	補破衣裳	pu phou i zaon
補鑊子個	补镬子个	補鑊子個	pu ghoq tsy goq
布店	布店	布店	pu ti
布機	布机	布機	pu ci
布鞋	布鞋	布鞋	pu gha
布告	布告	佈告	pu kau
布襴	布襕	布襴	pu lae
布衫	布衫	布衫	pu sae
布頭襱	布头襱	布頭襱	pu deu lon
鋪陳	铺陈	鋪陳	phu jin
潽	潽	潽	phu1
鋪	铺	鋪	phu5
鋪烏○	铺乌○	鋪烏○	phu u
鋪蓋	铺盖	鋪蓋	phu ke
鋪板	铺板	鋪板	phu pae
菩薩	菩萨	菩薩	bu saq
步鴣	步鸪	步鴣	bu ku
部	部	部	bu4
埠頭	埠头	埠頭	bu deu
蒲○	蒲○	蒲○	bu6
蒲薺	蒲荠	蒲薺	bu ji
蒲扇	蒲扇	蒲扇	bu shi
蒲鞋	蒲鞋	蒲鞋	bu gha
蒲包	蒲包	蒲包	bu pau
蒲帽	蒲帽	蒲帽	bu mau
蒲墩	蒲墩	蒲墩	bu ten
蒲團	蒲团	蒲團	bu doe
孵	孵	孵	bu6
伏	伏	伏	bu6
孵胎蛋	孵胎蛋	孵胎蛋	bu the dae
孵蛋	孵蛋	孵蛋	bu dae
孵小雞	孵小鸡	孵小雞	bu shiau ci
孵豆芽	孵豆芽	孵豆芽	bu deu ngo
孵秧子	孵秧子	孵秧子	bu ian tsy
𥳖	𥳖	𥳖	bu4
夫妻	夫妻	夫妻	fu chi
呼嘯蛇	呼啸蛇	呼嘯蛇	fu shiau dzo
敷藥	敷药	敷藥	fu yaq
膚殼衣	肤壳衣	膚殼衣	fu khoq i
麩皮	麸皮	麩皮	fu bi
麩炭	麸炭	麩炭	fu thae
㩤	㩤	㩤	fu1
斧頭	斧头	斧頭	fu deu
斧頭包	斧头包	斧頭包	fu deu pau
斧頭蟑螂	斧头蟑螂	斧頭蟑螂	fu deu tsaon laon
虎口	虎口	虎口	fu kheu
戽	戽	戽	fu5
戽斗	戽斗	戽斗	fu teu
副	副	副	fu5
富庶	富庶	富庶	fu syu
富陽灰	富阳灰	富陽灰	fu yan huei
扶手	扶手	扶手	vu shieu
芙蓉花	芙蓉花	芙蓉花	vu yon huo
腐	腐	腐	vu6
腐奇奇	腐奇奇	腐奇奇	vu ji ji
腐奇刮勒	腐奇刮勒	腐奇刮勒	vu ji kuaq laq
腐奇涾勒	腐奇涾勒	腐奇涾勒	vu ji daq laq
腐𤒻𤒻	腐𪹹𪹹	腐𤒻𤒻	vu daq daq
腐竹	腐竹	腐竹	vu tsoq
都整	都整	都整	tu cin
肚	肚	肚	tu3
肚子	肚子	肚子	tu tsy
賭坯	赌坯	賭坯	tu phei
賭客	赌客	賭客	tu khaq
土司	土司	土司	thu sy
土笥	土笥	土笥	thu sy
土匪	土匪	土匪	thu fi
土地堂	土地堂	土地堂	thu di daon
土箕	土箕	土箕	thu ci
土布	土布	土布	thu pu
土鯆魚	土𫚙鱼	土鯆魚	thu bu ng
土郎中	土郎中	土郎中	thu laon tson
土黄	土黄	土黃	thu waon
土燭	土烛	土燭	thu tsoq
吐絲	吐丝	吐絲	thu sy
吐清水	吐清水	吐清水	thu chin syu
兔子	兔子	兔子	thu tsy
兔	兔	兔	thu5
堍頭	堍头	堍頭	thu deu
徒弟	徒弟	徒弟	du di
途○	途○	途○	du2
圖書	图书	圖書	du syu
圖畫釘	图画钉	圖畫釘	du wo tin
杜阻○	杜阻○	杜阻○	du tsu
杜勒克	杜勒克	杜勒克	du laq khaq
杜勒克牌	杜勒克牌	杜勒克牌	du laq khaq ba
杜勒克牌	杜勒克牌	杜勒克牌	du laq khaq bae
肚皮	肚皮	肚皮	du bi
肚皮⿸尸查	肚皮⿸尸查	肚皮⿸尸查	du bi dza
肚皮痛	肚皮痛	肚皮痛	du bi thon
肚裏貨	肚里货	肚裏貨	du li hou
肚饑	肚饥	肚飢	du ci
肚臍眼	肚脐眼	肚臍眼	du ji ngae
肚仙婆	肚仙婆	肚仙婆	du shi bou
肚下白	肚下白	肚下白	du gho baq
肚才	肚才	肚才	du dze
肚兜	肚兜	肚兜	du teu
肚綳	肚绷	肚繃	du pan
肚腸	肚肠	肚腸	du jian
肚檔	肚档	肚檔	du taon
度	度	度	du6
度死	度死	度死	du shi
渡口	渡口	渡口	du kheu
滷	卤	滷	lu2
盧○琴	卢○琴	盧○琴	lu jin
蘆穄	芦穄	蘆穄	lu ci
蘆穄桿	芦穄杆	蘆穄桿	lu ci kI
蘆穄掃帚	芦穄扫帚	蘆穄掃帚	lu ci sau cieu
蘆花	芦花	蘆花	lu huo
蘆花鷄	芦花鸡	蘆花雞	lu huo ci
蘆葦	芦苇	蘆葦	lu wei
蘆根	芦根	蘆根	lu ken
蘆箬	芦箬	蘆箬	lu gniaq
蘆席	芦席	蘆蓆	lu zhiq
鱸魚	鲈鱼	鱸魚	lu ng
鹵除○	卤除○	滷除○	lu dzyu
路	路	路	lu6
路吹	路吹	路吹	lu tshyu
路邊頭	路边头	路邊頭	lu pi deu
路裏	路里	路裏	lu li
路西頭	路西头	路西頭	lu shi deu
路數	路数	路數	lu su
路道	路道	路道	lu dau
路條	路条	路條	lu diau
路梯	路梯	路梯	lu the
路梯棚頭	路梯棚头	路梯棚頭	lu the ban deu
路梯檔	路梯档	路梯檔	lu the taon
路梯門	路梯门	路梯門	lu the men
路菜	路菜	路菜	lu tshe
路南頭	路南头	路南頭	lu nEI deu
路東頭	路东头	路東頭	lu ton deu
路北頭	路北头	路北頭	lu poq deu
櫓	橹	櫓	lu6
櫓柱頭	橹柱头	櫓柱頭	lu dzyu deu
櫓臍眼	橹脐眼	櫓臍眼	lu ji ngae
櫓烏柱	橹乌柱	櫓烏柱	lu u dzyu
櫓帶	橹带	櫓帶	lu tan
櫓手	橹手	櫓手	lu shieu
櫓葉	橹叶	櫓葉	lu yiq
露水	露水	露水	lu syu
露水夫妻	露水夫妻	露水夫妻	lu syu fu chi
鷺鷥	鹭鸶	鷺鷥	lu sy
祖基	祖基	祖基	tsu ci
祖宗堂	祖宗堂	祖宗堂	tsu tson daon
初	初	初	tshu1
初外	初外	初外	tshu nga
初頭	初头	初頭	tshu deu
初十邊	初十边	初十邊	tshu zyuq pi
粗鹽	粗盐	粗鹽	tshu yi
粗拉柴	粗拉柴	粗拉柴	tshu la za
粗坯	粗坯	粗坯	tshu phei
粗生活	粗生活	粗生活	tshu san wo
粗糠	粗糠	粗糠	tshu khaon
瘄子	瘄子	瘄子	tshu tsy
鋤地	锄地	鋤地	dzu di
梳打餅乾	梳打饼干	梳打餅乾	su tan pin kI
梳妝臺	梳妆台	梳妝檯	su tsaon de
蘇頭	苏头	蘇頭	su deu
數	数	數	su3
素鷄	素鸡	素雞	su ci
素齋	素斋	素齋	su tsa
素下飯	素下饭	素下飯	su gho vae
素小菜	素小菜	素小菜	su shiau tshe
素油	素油	素油	su yeu
素大腸	素大肠	素大腸	su dou jian
素淨	素净	素淨	su zhin
塑子	塑子	塑子	su tsy
數	数	數	su5
數目	数目	數目	su moq
估	估	估	ku1
咕咕忖	咕咕忖	咕咕忖	ku ku tshen
孤老	孤老	孤老	ku lau
孤老太婆	孤老太婆	孤老太婆	ku lau tha bou
孤老頭	孤老头	孤老頭	ku lau deu
孤孀老𡢿	孤孀老𡢿	孤孀老𡢿	ku saon lau gnion
孤孀	孤孀	孤孀	ku saon
姑嬷	姑嬷	姑嬤	ku mho
姑嬷頭	姑嬷头	姑嬤頭	ku mho deu
姑婆	姑婆	姑婆	ku bou
姑丈	姑丈	姑丈	ku jian
姑丈公	姑丈公	姑丈公	ku jian kon
古銅色	古铜色	古銅色	ku don saq
股	股	股	ku3
牯豬	牯猪	牯豬	ku tsyu
臌脹病	臌胀病	臌脹病	ku cian bin
僱工	雇工	僱工	ku kon
僱着	雇着	僱着	ku zyuq
顧野	顾野	顧野	ku ya
顧着	顾着	顧着	ku zyuq
枯殼衣	枯壳衣	枯殼衣	khu khoq i
箍	箍	箍	khu1
箍桶	箍桶	箍桶	khu don
箍桶師父	箍桶师父	箍桶師父	khu don sy vu
骷顱頭	骷颅头	骷顱頭	khu lu deu
骷郎頭	骷郎头	骷郎頭	khu laon deu
骷顱頭甏	骷颅头甏	骷顱頭甏	khu lu deu ban
骷顱頭瓶	骷颅头瓶	骷顱頭瓶	khu lu deu bin
苦	苦	苦	khu3
苦意頭	苦意头	苦意頭	khu i deu
苦膽	苦胆	苦膽	khu tae
苦瓜	苦瓜	苦瓜	khu kuo
苦頭	苦头	苦頭	khu deu
苦相出	苦相出	苦相出	khu shian tshyuq
苦相擺出	苦相摆出	苦相擺出	khu shian pa tshyuq
苦得得	苦得得	苦得得	khu taq taq
苦頓頓	苦顿顿	苦頓頓	khu ten ten
庫房	库房	庫房	khu vaon
褲	裤	褲	khu5
裤帶	裤带	褲帶	khu ta
褲腰	裤腰	褲腰	khu iau
褲袋	裤袋	褲袋	khu de
褲襠	裤裆	褲襠	khu taon
褲腳	裤脚	褲腳	khu ciaq
褲腳管	裤脚管	褲腳管	khu ciaq kun
褲腳筒	裤脚筒	褲腳筒	khu ciaq don
褲腳	裤脚	褲腳	khu ciaq
跍	跍	跍	gu2
咕	咕	咕	gu6
和	和	和	wu2
狐狸	狐狸	狐狸	wu li
胡桃	胡桃	胡桃	wu dau
胡桃紐	胡桃纽	胡桃紐	wu dau gnieu
胡椒	胡椒	胡椒	wu ciau
胡椒粉	胡椒粉	胡椒粉	wu ciau fen
胡籮葡	胡箩葡	胡籮葡	wu lou bu
胡○喚○頭	胡○唤○头	胡○喚○頭	wu hun deu
胡琴	胡琴	胡琴	wu jin
胡嚨	胡咙	胡嚨	wu lon
胡嚨頭	胡咙头	胡嚨頭	wu lon deu
壺	壶	壺	wu2
葫蘆	葫芦	葫蘆	wu lu
湖	湖	湖	wu2
湖綠	湖绿	湖綠	wu loq
無賴	无赖	無賴	Wu la
無名指	无名指	無名指	Wu min tsy
無核橘	无核橘	無核橘	Wu ghaq ciuq
蝴蝶	蝴蝶	蝴蝶	wu diaq
蝴蝶結	蝴蝶结	蝴蝶結	wu diaq ciq
糊	糊	糊	wu2
糊裏糊塗	糊里糊涂	糊裏糊塗	wu li wu du
糊千達萬	糊千达万	糊千達萬	wu chi daq vae
户頭	户头	戶頭	wu deu
午	午	午	wu4
戊	戊	戊	Wu6
武耍耍	武耍耍	武耍耍	Wu sa sa
武旦	武旦	武旦	Wu tae
武生	武生	武生	Wu san
務心竭力	务心竭力	務心竭力	Wu shin jiq liq
梧桐樹	梧桐树	梧桐樹	wu don zyu
舞龍燈	舞龙灯	舞龍燈	Wu lon ten
霧露	雾露	霧露	Wu lu
護士	护士	護士	wu zy
護城河	护城河	護城河	wu jin ghou
污蘇○	污苏○	污蘇○	u su
洿	洿	洿	u1
烏	乌	烏	u1
烏紫楊梅	乌紫杨梅	烏紫楊梅	u tsy yan mei
烏珠	乌珠	烏珠	u tsyu
烏嘴烏臉	乌嘴乌脸	烏嘴烏臉	u tsyu u li
烏鱧魚	乌鳢鱼	烏鱧魚	u li ng
烏鱧魚瓜	乌鳢鱼瓜	烏鱧魚瓜	u li ng kuo
烏龜	乌龟	烏龜	u ciu
烏龜頭	乌龟头	烏龜頭	u ciu deu
烏龜頭蟲	乌龟头虫	烏龜頭蟲	u ciu deu dzon
烏鼻頭蟲	乌鼻头虫	烏鼻頭蟲	u baq deu dzon
烏龜强盜坯	乌龟强盗坯	烏龜強盜坯	u ciu jian dau phei
烏早天亮	乌早天亮	烏早天亮	u tsau thiq gnian
烏○采○	乌○采○	烏○采○	u tshe
烏○賽○	乌○赛○	烏○賽○	u se
烏○蕩○	乌○荡○	烏○蕩○	u daon
烏○頭○	乌○头○	烏○頭○	u deu
烏○態○	乌○态○	烏○態○	u the
烏斑	乌斑	烏斑	u pae
烏溜溜	乌溜溜	烏溜溜	u lieu lieu
烏油油	乌油油	烏油油	u yeu yeu
烏青	乌青	烏青	u chin
烏青塊	乌青块	烏青塊	u chin khuei
烏雲	乌云	烏雲	u yun
烏笋	乌笋	烏筍	u syun
烏龍松○	乌龙松○	烏龍松○	u lon son
烏倫○村○	乌伦○村○	烏倫○村○	u len tshen
烏賊	乌贼	烏賊	u zaq
烏賊肚腸	乌贼肚肠	烏賊肚腸	u zaq du jian
烏賊卵丸	乌贼卵丸	烏賊卵丸	u zaq loe wun
烏賊蛋	乌贼蛋	烏賊蛋	u zaq dae
烏賊鯗	乌贼鲞	烏賊鯗	u zaq shian
烏賊韌	乌贼韧	烏賊韌	u zaq gnin
烏賊混子	乌贼混子	烏賊混子	u zaq wen tsy
烏腳鷄	乌脚鸡	烏腳雞	u ciaq ci
萵笋	莴笋	萵筍	u syun
誣告	诬告	誣告	u kau
誣告	诬告	誣告	Wu kau
熓敦敦	𤆡敦敦	熓敦敦	u ten ten
捂心	捂心	捂心	u shin
焐	焐	焐	u5
焐酥豆	焐酥豆	焐酥豆	u su deu
車	车	車	ciu1
絹帕	绢帕	絹帕	ciu phae
鬼剃頭	鬼剃头	鬼剃頭	ciu thi deu
鬼頭風	鬼头风	鬼頭風	ciu deu fon
捲心菜	卷心菜	捲心菜	ciu shin tshe
捲尺	卷尺	捲尺	ciu tshaq
捲筆刀	卷笔刀	卷筆刀	ciu piq tau
舉手	举手	舉手	ciu shieu
句	句	句	ciu5
貴	贵	貴	ciu5
貴上	贵上	貴上	ciu zaon
虧煞	亏煞	虧煞	chiu saq
虧勒	亏勒	虧勒	chiu laq
圈	圈	圈	chiu3
圈癣	圈癣	圈癬	chiu shi
去風	去风	去風	chi fon
去濕	去湿	去溼	chiu shiq
拳頭	拳头	拳頭	jiu deu
拳頭捏起	拳头捏起	拳頭捏起	jiu deu gniaq chi
顴骨	颧骨	顴骨	jiu kuaq
櫃臺	柜台	櫃檯	jiu de
櫃頭獅子	柜头狮子	櫃頭獅子	jiu deu sy tsy
櫃頭活猻	柜头活狲	櫃頭活猻	jiu deu waq sen
櫃牀	柜床	櫃牀	jiu zaon
元寶茶	元宝茶	元寶茶	gniu pau dzo
元寶籃	元宝篮	元寶籃	gniu pau lae
元寶桌	元宝桌	元寶桌	gniu pau tsoq
元寶魚	元宝鱼	元寶魚	gniu pau ng
原告	原告	原告	gniu kau
原配	原配	原配	gniu phei
愚豬	愚猪	愚豬	gniu tsyu
女婿	女婿	女婿	gniu shi
女家	女家	女家	gniu ko
女人	女人	女人	gniu gnin
女人家	女人家	女人家	gniu gnin ko
女人頭	女人头	女人頭	gniu gnin deu
女人爿	女人爿	女人爿	gniu gnin bae
女人客	女人客	女人客	gniu gnin khaq
軟	软	軟	gniu4
軟綿綿	软绵绵	軟綿綿	gniu mi mi
軟柴	软柴	軟柴	gniu za
軟菜	软菜	軟菜	gniu tshe
軟泛泛	软泛泛	軟泛泛	gniu fae fae
軟相	软相	軟相	gniu shian
軟糖	软糖	軟糖	gniu daon
軟塌皮	软塌皮	軟塌皮	gniu thaq bi
軟塌塌	软塌塌	軟塌塌	gniu thaq thaq
蕊頭	蕊头	蕊頭	gniu deu
虚頭	虚头	虛頭	shiu deu
虚腫	虚肿	虛腫	shiu tson
虚㽺病	虚㽺病	虛㽺病	shiu shiq bin
楦頭	楦头	楦頭	shiu deu
毁	毁	毀	shiu5
㧦	㧦	㧦	shiu5
玄色	玄色	玄色	yu saq
圍巾	围巾	圍巾	yu cin
圍身布欄	围身布栏	圍身布欄	yu shin pu lae
圍裙	围裙	圍裙	yu jiun
榆樹	榆树	榆樹	yu zyu
圓	圆	圓	yu2
圓子	圆子	圓子	yu tsy
圓絲藍	圆丝蓝	圓絲藍	yu sy lae
圓矮凳	圆矮凳	圓矮凳	yu a ten
圓凳	圆凳	圓凳	yu ten
圓臺面	圆台面	圓臺面	yu de mi
圆規	圆规	圓規	yu kuei
圓領衫	圆领衫	圓領衫	yu lin sae
圓蛤	圆蛤	圓蛤	yu kaq
圓桌	圆桌	圓桌	yu tsoq
圓桌凳	圆桌凳	圓桌凳	yu tsoq ten
餘多	余多	餘多	yu tou
懸凌	悬凌	懸凌	yu lin
懸勢	悬势	懸勢	yu syu
羽毛球	羽毛球	羽毛球	yu mau jieu
雨	雨	雨	yu4
雨字頭	雨字头	雨字頭	yu zy deu
雨水	雨水	雨水	yu syu
雨披	雨披	雨披	yu phi
雨點	雨点	雨點	yu ti
雨衣	雨衣	雨衣	yu i
雨毛絲	雨毛丝	雨毛絲	yu mau sy
雨毛滯滯	雨毛滞滞	雨毛滯滯	yu mau ji ji
雨傘	雨伞	雨傘	yu sae
雨棚	雨棚	雨棚	yu ban
雨夾雪	雨夹雪	雨夾雪	yu kaq syuq
雨壓落來	雨压落来	雨壓落來	yu aq loq le
預製板	预制板	預製板	yu tsyu pae
遠視眼	远视眼	遠視眼	yu zy ngae
遠足	远足	遠足	yu tsoq
衣櫥	衣橱	衣櫥	iu dzyu
衣櫥	衣橱	衣櫥	u dzyu
冤家	冤家	冤家	iu ko
冤綳	冤绷	冤繃	iu pan
冤枉	冤枉	冤枉	iu uaon
淤血	淤血	淤血	iu shiuq
鴛鴦	鸳鸯	鴛鴦	iu ian
椅子	椅子	椅子	iu tsy
椅子	椅子	椅子	u tsy
椅子	椅子	椅子	i tsy
椅子背	椅子背	椅子背	iu tsy pei
椅子背	椅子背	椅子背	u tsy pei
椅子背	椅子背	椅子背	i tsy pei
䩩	䩩	䩩	iu3
叭兒狗	叭儿狗	叭兒狗	pa er keu
擺	摆	擺	pa3
擺渡	摆渡	擺渡	pa du
擺渡船	摆渡船	擺渡船	pa du zOE
擺俏功	摆俏功	擺俏功	pa chiau kon
擺攤頭	摆摊头	擺攤頭	pa thae deu
擺場面	摆场面	擺場面	pa jian mi
擺平	摆平	擺平	pa bin
擺明	摆明	擺明	pa min
擺攤	摆摊	擺攤	pa thae
爸爸	爸爸	爸爸	pa pa
拜歲	拜岁	拜歲	pa syu
拜懺	拜忏	拜懺	pa tshae
拜生	拜生	拜生	pa san
拜梁王	拜梁王	拜梁王	pa lian waon
拜堂	拜堂	拜堂	pa daon
派	派	派	pha5
派○	派○	派○	pha5
派司牌	派司牌	派司牌	pha sy bae
派○賴○	派○赖○	派○賴○	pha la
派來	派来	派來	pha le
排	排	排	ba2
排○排○船	排○排○船	排○排○船	ba ba zOE
排銷	排销	排銷	ba shiau
排球	排球	排球	ba jieu
排頭	排头	排頭	ba deu
排場	排场	排場	ba jian
排門	排门	排門	ba men
排門板	排门板	排門板	ba men pae
排八字	排八字	排八字	ba paq zy
排骨	排骨	排骨	ba kuaq
排刷	排刷	排刷	ba syuq
牌子	牌子	牌子	ba tsy
牌九	牌九	牌九	ba cieu
牌位	牌位	牌位	ba wei
敗子	败子	敗子	ba tsy
敗家子	败家子	敗家子	ba ko tsy
敗家精	败家精	敗家精	ba ko cin
敗門枋	败门枋	敗門枋	ba men faon
鮊魚	鲌鱼	鮊魚	ba ng
☐	☐	☐	mha1
☐	☐	☐	ma2
埋怨	埋怨	埋怨	ma iu
馬馬虎虎	马马虎虎	馬馬虎虎	ma ma fu fu
買主	买主	買主	ma tsyu
買面孔	买面孔	買面孔	ma mi khon
買面子	买面子	買面子	ma mi tsy
買賬	买账	買賬	ma cian
買勿出	买勿出	買勿出	ma vaq tshyuq
賣爹賣孃	卖爹卖娘	賣爹賣娘	ma tia ma gnian
賣野人頭	卖野人头	賣野人頭	ma ya gnin deu
賣相	卖相	賣相	ma shian
賣旺	卖旺	賣旺	ma waon
賣藥郎中	卖药郎中	賣藥郎中	ma yaq laon tson
𠲎	𠲎	𠲎	va2
帶	带	帶	ta5
帶	带	帶	tae5
帶孝	带孝	帶孝	ta hau
帶豆	带豆	帶豆	ta deu
帶信	带信	帶信	ta shin
帶髮尼姑	带发尼姑	帶發尼姑	ta faq gni ku
帶魚	带鱼	帶魚	ta ng
戴高帽子	戴高帽子	戴高帽子	ta kau mau tsy
它山堰	它山堰	它山堰	tha sae i
太師椅	太师椅	太師椅	tha sy i
太師椅	太师椅	太師椅	tha sy iu
太太	太太	太太	tha tha
太○饒	太○饶	太○饒	tha gniau
太婆	太婆	太婆	tha bou
太陽	太阳	太陽	tha yan
太陽底下	太阳底下	太陽底下	tha yan ti gho
太陽菩薩	太阳菩萨	太陽菩薩	tha yan bu saq
太陽帽	太阳帽	太陽帽	tha yan mau
太陽眼	太阳眼	太陽眼	tha yan ngae
太陽堆裏	太阳堆里	太陽堆裏	tha yan tei li
太陽穴	太阳穴	太陽穴	tha yan yuq
太陰菩薩	太阴菩萨	太陰菩薩	tha in bu saq
太公	太公	太公	tha kon
太白星	太白星	太白星	tha baq shin
埭	埭	埭	da2
大字	大字	大字	da zy
大字簿	大字簿	大字簿	da zy bu
大便	大便	大便	da bi
大解	大解	大解	da ka
大殮	大殓	大殮	da li
大麗花	大丽花	大麗花	da li huo
大度	大度	大度	da du
大路	大路	大路	da lu
大寫字	大写字	大寫字	da shia zy
大考	大考	大考	da khau
大菜	大菜	大菜	da tshe
大菜師父	大菜师父	大菜師父	da tshe sy vu
廚工師父	厨工师父	廚工師父	dzyu kon sy vu
大菜桌燈	大菜桌灯	大菜桌燈	da tshe tsoq ten
大菜臺子	大菜台子	大菜臺子	da tshe de tsy
大蒜	大蒜	大蒜	da soe
大蒜頭	大蒜头	大蒜頭	da soe deu
大圈結	大圈结	大圈結	da chiu ciq
大亨	大亨	大亨	da han
大方	大方	大方	da faon
大青頭	大青头	大青頭	da chin deu
大身	大身	大身	da shin
大紅	大红	大紅	da ghon
大約毛	大约毛	大約毛	da iaq mau
大約	大约	大約	da iaq
𢪂	𢪂	𢪂	da6
𢪂𢪂腐	𢪂𢪂腐	𢪂𢪂腐	da da vu
𢪂頭皮	𢪂头皮	𢪂頭皮	da deu bi
𢪂癢棒	𢪂痒棒	𢪂癢棒	da yan baon
𢪂藤	𢪂藤	𢪂藤	da den
哪	哪	哪	nha1
哪	哪	哪	naq8
淖泥	淖泥	淖泥	na gni
淖泥菩薩	淖泥菩萨	淖泥菩薩	na gni bu saq
淖泥污漿	淖泥污浆	淖泥污漿	na gni u cian
淖泥塊	淖泥块	淖泥塊	na gni khuei
奶水	奶水	奶水	na syu
奶奶婆	奶奶婆	奶奶婆	na na bou
奶糕	奶糕	奶糕	na kau
奶牙	奶牙	奶牙	na ngo
奶花香	奶花香	奶花香	na huo shian
奶香	奶香	奶香	na shian
奶酣	奶酣	奶酣	na he
奶油	奶油	奶油	na yeu
奶油包頭	奶油包头	奶油包頭	na yeu pau deu
奶油小生	奶油小生	奶油小生	na yeu shiau san
奶油色	奶油色	奶油色	na yeu saq
奶頭	奶头	奶頭	na deu
奶奶頭	奶奶头	奶奶頭	na na deu
奶黄	奶黄	奶黃	na waon
奶花	奶花	奶花	na hun
奶嬸	奶婶	奶嬸	na shin
奶𤷾	奶𤷾	奶𤷾	na chiq
嬲嬲和	嬲嬲和	嬲嬲和	na na ghou
嬲嬲和	嬲嬲和	嬲嬲和	na na wu
嬲和	嬲和	嬲和	na ghou
嬲和	嬲和	嬲和	na wu
嬲和嬉頭	嬲和嬉头	嬲和嬉頭	na ghou shi deu
嬲和嬉頭	嬲和嬉头	嬲和嬉頭	na wu shi deu
嬲和東西	嬲和东西	嬲和東西	na ghou ton shi
嬲和東西	嬲和东西	嬲和東西	na wu ton shi
拉買主	拉买主	拉買主	lha ma tsyu
拉柴	拉柴	拉柴	lha za
拉馬	拉马	拉馬	lha mo
拉關係	拉关系	拉關係	lha kuae shi
拉手	拉手	拉手	lha shieu
啦	啦	啦	lha1
啦	啦	啦	laq8
剌開	剌开	剌開	la khe
垃圾	垃圾	垃圾	la shi
垃圾畚斗	垃圾畚斗	垃圾畚斗	la shi pen teu
喇叭	喇叭	喇叭	la pa
喇叭褲	喇叭裤	喇叭褲	la pa khu
喇叭花	喇叭花	喇叭花	la pa huo
喇叭裙	喇叭裙	喇叭裙	la pa jiun
喇叭袖	喇叭袖	喇叭袖	la pa zhieu
賴	赖	賴	la6
賴孵	赖孵	賴孵	la bu
賴孵鷄	赖孵鸡	賴孵雞	la bu ci
賴○柴鬍子	赖○柴胡子	賴○柴鬍子	la za wu tsy
賴花頭	赖花头	賴花頭	la huo deu
賴三	赖三	賴三	la sae
賴屙皮	赖屙皮	賴屙皮	la ou bi
賴臭皮	赖臭皮	賴臭皮	la chieu bi
賴賬	赖账	賴賬	la cian
賴婚	赖婚	賴婚	la huen
賴學	赖学	賴學	la ghoq
賴學精	赖学精	賴學精	la ghoq cin
攋	𪮶	攋	la4
攋草耙	𪮶草耙	攋草耙	la tshau bo
攋藤	𪮶藤	攋藤	la den
癩施○	癞施○	癩施○	la sy
癩施○蛤蚆	癞施○蛤蚆	癩施○蛤蚆	la sy kaq po
癩史○哥○	癞史○哥○	癩史○哥○	la sy kou
癩嘴小娘	癞嘴小娘	癩嘴小娘	la tsyu shiau gnian
癩頭	癞头	癩頭	la deu
癩頭花	癞头花	癩頭花	la deu huo
癩頭兒子	癞头儿子	癩頭兒子	la deu ng tsy
癩蛤蚆	癞蛤蚆	癩蛤蚆	la kaq po
差	差	差	tsha1
差○	差○	差○	tsha1
差○板桌	差○板桌	差○板桌	tsha pae tsoq
差○活○	差○活○	差○活○	tsha waq
差○魚	差○鱼	差○魚	tsha ng
差○魚頭	差○鱼头	差○魚頭	tsha ng deu
蔡○眼	蔡○眼	蔡○眼	tsha ngae
⿸尸查	⿸尸查	⿸尸查	dza4
⿸尸查尿	⿸尸查尿	⿸尸查尿	dza syu
⿸尸查屁蟲	⿸尸查屁虫	⿸尸查屁蟲	dza phi dzon
⿸尸查痢疾	⿸尸查痢疾	⿸尸查痢疾	dza li jiq
⿸尸查肚皮	⿸尸查肚皮	⿸尸查肚皮	dza du bi
⿸尸查尿撲	⿸尸查尿扑	⿸尸查尿撲	dza syu phoq
⿸尸查爛屙	⿸尸查烂屙	⿸尸查爛屙	dza lae ou
⿸尸查屙	⿸尸查屙	⿸尸查屙	dza ou
⿸尸查屙撲	⿸尸查屙扑	⿸尸查屙撲	dza ou phoq
⿸尸查屙出	⿸尸查屙出	⿸尸查屙出	dza ou tshyuq
咋	咋	咋	dza4
咋依八𠡒	咋依八𠡒	咋依八𠡒	dza i paq tei
咋貌	咋貌	咋貌	dza mau
咋貌介	咋貌介	咋貌介	dza mau ka
咋貌介	咋貌介	咋貌介	dza mau kaq
咋相貌	咋相貌	咋相貌	dza shian mau
咋相貌介	咋相貌介	咋相貌介	dza shian mau ka
咋相貌介	咋相貌介	咋相貌介	dza shian mau kaq
咋話	咋话	咋話	dza wo
咋管	咋管	咋管	dza kun
咋弄	咋弄	咋弄	dza lon
咋弄弄	咋弄弄	咋弄弄	dza lon lon
咋結煞	咋结煞	咋結煞	dza ciq saq
灑藥水	洒药水	灑藥水	sa yaq syu
曬花⿱寨	晒花⿱寨	曬花⿱寨	sa huo za
曬臺	晒台	曬臺	sa de
曬場	晒场	曬場	sa jian
曬癟葛藤	晒瘪葛藤	曬癟葛藤	sa piq kaq den
曬日頭菩	晒日头菩	曬日頭菩	sa gniq deu bu
柴	柴	柴	za2
柴刀	柴刀	柴刀	za tau
柴爿	柴爿	柴爿	za bae
柴間	柴间	柴間	za kae
柴油	柴油	柴油	za yeu
柴油桶	柴油桶	柴油桶	za yeu don
柴堆	柴堆	柴堆	za tei
柴蓬	柴蓬	柴蓬	za bon
柴白絳花	柴白绛花	柴白絳花	za baq cian huo
柴角卵	柴角卵	柴角卵	za koq loe
豺狗	豺狗	豺狗	za keu
㩟	㩟	㩟	za6
⿱寨	⿱寨	⿱寨	za6
⿱寨魚	⿱寨鱼	⿱寨魚	za ng
階沿	阶沿	階沿	ka yi
街面屋	街面屋	街面屋	ka mi oq
街面房子	街面房子	街面房子	ka mi vaon tsy
街裏	街里	街裏	ka li
解樹螂	解树螂	解樹螂	ka zyu laon
解板	解板	解板	ka pae
解手	解手	解手	ka shieu
解縛	解缚	解縛	ka bou
解匠	解匠	解匠	ka zhian
解放帽	解放帽	解放帽	ka faon mau
解毒	解毒	解毒	ka doq
介	介	介	ka5
介	介	介	kaq7
介…既…	介…既…	介…既…	ka ci
介𡀂	介𡀂	介𡀂	ka lei
介管	介管	介管	ka kun
介辰光	介辰光	介辰光	ka zyun kuaon
戒指	戒指	戒指	ka tsy
戒厭	戒厌	戒厭	ka i
芥菜	芥菜	芥菜	ka tshe
庎櫥	庎橱	庎櫥	ka dzyu
屆	届	屆	ka5
解	解	解	ka5
解鈔票	解钞票	解鈔票	ka tshau phiau
揩	揩	揩	kha1
揩布	揩布	揩布	kha pu
揩油	揩油	揩油	kha yeu
揩桌布	揩桌布	揩桌布	kha tsoq pu
揩刷	揩刷	揩刷	kha syuq
揩刷團	揩刷团	揩刷團	kha syuq doe
卡車	卡车	卡車	kha tsho
茄○茄○鴨	茄○茄○鸭	茄○茄○鴨	ga ga ae
解	解	解	ga4
懈	懈	懈	ga4
懈舒舒	懈舒舒	懈舒舒	ga syu syu
懈門	懈门	懈門	ga men
懈口	懈口	懈口	ga kheu
外地人	外地人	外地人	nga di gnin
外快	外快	外快	nga khua
外碼頭	外码头	外碼頭	nga mo deu
外間	外间	外間	nga kae
外紐	外纽	外紐	nga gnieu
外婆	外婆	外婆	nga bou
外婆家	外婆家	外婆家	nga bou ko
外婆暈	外婆晕	外婆暈	nga bou yun
外鵝	外鹅	外鵝	nga ngou
外頭人	外头人	外頭人	nga deu gnin
外甥頑	外甥顽	外甥頑	nga san uae
外甥囡	外甥囡	外甥囡	nga san noe
外廂	外厢	外廂	nga shian
外頭	外头	外頭	nga deu
外行	外行	外行	nga ghaon
外行結夾	外行结夹	外行結夾	nga ghaon ciq kaq
外勤	外勤	外勤	nga jin
外公	外公	外公	nga kon
外八字	外八字	外八字	nga paq zy
外國紅	外国红	外國紅	nga koq ghon
捱	挨	捱	nga6
捱過	挨过	捱過	nga kou
蟹	蟹	蟹	ha3
蟹米鬚	蟹米须	蟹米鬚	ha mi syu
蟹肚子	蟹肚子	蟹肚子	ha tu tsy
蟹包	蟹包	蟹包	ha pau
蟹和尚	蟹和尚	蟹和尚	ha ghou zaon
蟹肚臍	蟹肚脐	蟹肚臍	ha du ji
蟹糊	蟹糊	蟹糊	ha wu
蟹爪菊	蟹爪菊	蟹爪菊	ha tsau ciuq
蟹醬	蟹酱	蟹醬	ha cian
蟹黄	蟹黄	蟹黃	ha uaon
蟹粉	蟹粉	蟹粉	ha fen
蟹青	蟹青	蟹青	ha chin
蟹腳鉗	蟹脚钳	蟹腳鉗	ha ciaq ji
蟹殼黄	蟹壳黄	蟹殼黃	ha khoq waon
蟹殼頂	蟹壳顶	蟹殼頂	ha khoq tin
蟹蓋頭	蟹盖头	蟹蓋頭	ha ke deu
鞋	鞋	鞋	gha2
鞋爿	鞋爿	鞋爿	gha bae
鞋面	鞋面	鞋面	gha mi
鞋底	鞋底	鞋底	gha ti
鞋底綫	鞋底线	鞋底線	gha ti shi
鞋○蒲○薺○	鞋○蒲○荠○	鞋○蒲○薺○	gha bu ji
鞋揎	鞋揎	鞋揎	gha shiu
鞋帶	鞋带	鞋帶	gha ta
鞋帽店	鞋帽店	鞋帽店	gha mau ti
鞋口	鞋口	鞋口	gha kheu
鞋幫	鞋帮	鞋幫	gha paon
鞋拔	鞋拔	鞋拔	gha baq
鞋舌頭	鞋舌头	鞋舌頭	gha zhiq deu
挨擠勿開	挨挤勿开	挨擠勿開	a ci vaq khe
挨攏	挨拢	挨攏	a lon
鸦片鬼	鸦片鬼	鴉片鬼	a phi ciu
㢊	㢊	㢊	a3
矮	矮	矮	a3
矮跍跍	矮跍跍	矮跍跍	a gu gu
矮墩墩	矮墩墩	矮墩墩	a ten ten
矮得得	矮得得	矮得得	a taq taq
矮棚狗	矮棚狗	矮棚狗	a ban keu
矮牆	矮墙	矮牆	a zhian
矮門	矮门	矮門	a men
矮凳	矮凳	矮凳	a ten
靉愁愁	叆愁愁	靉愁愁	a zeu zeu
爹	爹	爹	tia1
爹頭娘腳	爹头娘脚	爹頭孃腳	tia deu gnian ciaq
爹娘	爹娘	爹孃	tia gnian
嗲	嗲	嗲	tia3
家務事	家务事	家務事	cia Wu zy
家常便飯	家常便饭	家常便飯	cia dzaon bi vae
姐夫	姐夫	姐夫	cia fu
姐姐	姐姐	姐姐	cia cia
借	借	借	cia5
借肩背	借肩背	借肩背	cia ci pei
借○借○蟲	借○借○虫	借○借○蟲	cia cia dzon
借○手	借○手	借○手	cia shieu
借○手㪝槌	借○手㪝槌	借○手㪝槌	cia shieu li dzyu
借○手半邊	借○手半边	借○手半邊	cia shieu pun pi
借因頭	借因头	借因頭	cia in deu
借○八○利○	借○八○利○	借○八○利○	cia paq li
笡	笡	笡	chia3
笡擺	笡摆	笡擺	chia pa
笡擺笡	笡摆笡	笡擺笡	chia pa chia
笡對過	笡对过	笡對過	chia tei kou
笡對面	笡对面	笡對面	chia tei mi
笡對頭	笡对头	笡對頭	chia tei deu
笡頭	笡头	笡頭	chia deu
且是	且是	且是	chia zy
且顧	且顾	且顧	chia ku
且可	且可	且可	chia khou
茄子	茄子	茄子	jia tsy
寫字臺	写字台	寫字檯	shia zy de
寫字間	写字间	寫字間	shia zy kae
寫意	写意	寫意	shia i
寫白字眼	写白字眼	寫白字眼	shia baq zy ngae
㕐	㕐	㕐	shia3
㕐茶	㕐茶	㕐茶	shia dzo
㕐酒	㕐酒	㕐酒	shia cieu
㕐老酒	㕐老酒	㕐老酒	shia lau cieu
斜衣旁	斜衣旁	斜衣旁	zhia i baon
斜鈎	斜钩	斜鉤	zhia keu
斜王旁	斜王旁	斜王旁	zhia waon baon
斜白眼	斜白眼	斜白眼	zhia baq ngae
謝	谢	謝	zhia6
謝任	谢任	謝任	zhia gnin
夜	夜	夜	ya6
夜點心	夜点心	夜點心	ya ti shin
夜點心	夜点心	夜點心	ya te shin
夜快	夜快	夜快	ya khua
夜快點	夜快点	夜快點	ya khua ti
夜快邊	夜快边	夜快邊	ya khua pi
夜到	夜到	夜到	ya tau
夜到頭	夜到头	夜到頭	ya tau deu
夜頭	夜头	夜頭	ya deu
夜到晚頭	夜到晚头	夜到晚頭	ya tau mae deu
夜到末頭	夜到末头	夜到末頭	ya tau maq deu
夜稻	夜稻	夜稻	ya dau
夜稻時	夜稻时	夜稻時	ya dau zy
夜稻米	夜稻米	夜稻米	ya dau mi
夜叉	夜叉	夜叉	ya tsho
夜叫	夜叫	夜叫	ya ciau
夜來香	夜来香	夜來香	ya le shian
夜開花	夜开花	夜開花	ya khe huo
夜飯	夜饭	夜飯	ya vae
夜鱟	夜鲎	夜鱟	ya heu
夜羹飯	夜羹饭	夜羹飯	ya kan vae
夜場	夜场	夜場	ya jian
夜人客	夜人客	夜人客	ya gnin khaq
夜桶	夜桶	夜桶	ya don
夜桶箱	夜桶箱	夜桶箱	ya don shian
夜桶金箱	夜桶金箱	夜桶金箱	ya don cin shian
夜紅	夜红	夜紅	ya ghon
夜紅霞	夜红霞	夜紅霞	ya ghon ya
夜獨郎	夜独郎	夜獨郎	ya doq laon
野豬頭雲	野猪头云	野豬頭雲	ya tsyu deu yun
野鷄	野鸡	野雞	ya ci
野氣	野气	野氣	ya chi
野糊臉	野糊脸	野糊臉	ya wu li
野老公	野老公	野老公	ya lau kon
野貓	野猫	野貓	ya mae
野山笋	野山笋	野山筍	ya sae syun
野鴨	野鸭	野鴨	ya ae
野獸	野兽	野獸	ya shieu
呀呀糊	呀呀糊	呀呀糊	ia ia wu
拐	拐	拐	kua3
拐子	拐子	柺子	kua tsy
騙賊拐子	骗贼拐子	騙賊柺子	phi zaq kua tsy
拐籮窠	拐箩窠	拐籮窠	kua lou khou
拐腳	拐脚	拐腳	kua ciaq
快	快	快	khua5
快活	快活	快活	khua waq
快活人	快活人	快活人	khua waq gnin
懷裏	怀里	懷裏	gua li
歪	歪	歪	hua3
歪嘴	歪嘴	歪嘴	hua tsyu
歪嘴辟得	歪嘴辟得	歪嘴闢得	hua tsyu phiq taq
歪嘴辟腳	歪嘴辟脚	歪嘴闢腳	hua tsyu phiq ciaq
歪笡	歪笡	歪笡	hua chia
歪七𢺵八	歪七𢺵八	歪七𢺵八	hua chiq ji paq
還好	还好	還好	wa hau
還只	还只	還只	wa ciq
還只	还只	還只	gha ciq
懷錶	怀表	懷錶	wa piau
壞賬	坏账	壞賬	wa cian
壞	坏	壞	ua1
壞坯子	坏坯子	壞坯子	ua phei tsy
壞過	坏过	壞過	ua kou
壞喫	坏吃	壞吃	ua chioq
壞喫芋艿頭	坏吃芋艿头	壞吃芋艿頭	ua chioq n na deu
包	包	包	pau1
包子	包子	包子	pau tsy
包梢	包梢	包梢	pau sau
包眼	包眼	包眼	pau ngae
包頭	包头	包頭	pau deu
包頭布	包头布	包頭布	pau deu pu
包打聽	包打听	包打聽	pau tan thin
包管	包管	包管	pau kun
包心菜	包心菜	包心菜	pau shin tshe
包出頭	包出头	包出頭	pau tshyuq deu
胞	胞	胞	pau1
胞漿水	胞浆水	胞漿水	pau cian syu
保鑣	保镖	保鏢	pau piau
保頭人	保头人	保頭人	pau deu gnin
保本	保本	保本	pau pen
保國寺	保国寺	保國寺	pau koq zy
保出來	保出来	保出來	pau tshyuq le
飽膯膯	饱膯膯	飽膯膯	pau ten ten
寶蓋頭	宝盖头	寶蓋頭	pau ke deu
寶貨	宝货	寶貨	pau hou
豹	豹	豹	pau5
報喪	报丧	報喪	pau saon
暴	暴	暴	pau5
爆	爆	爆	pau5
爆冬米胖	爆冬米胖	爆冬米胖	pau ton mi phaon
拋錨	抛锚	拋錨	phau mau
泡	泡	泡	phau5
泡泡糖	泡泡糖	泡泡糖	phau phau daon
泡茶	泡茶	泡茶	phau dzo
泡開水	泡开水	泡開水	phau khe syu
泡飯	泡饭	泡飯	phau vae
泡湯	泡汤	泡湯	phau thaon
泡桐	泡桐	泡桐	phau don
泡○沖○	泡○冲○	泡○衝○	phau tshon
泡沫	泡沫	泡沫	phau maq
炮	炮	炮	phau5
炮仗	炮仗	炮仗	phau jian
刨	刨	刨	bau2
刨花	刨花	刨花	bau huo
刨娘	刨娘	刨娘	bau gnian
跑街先生	跑街先生	跑街先生	bau ka shi san
跑街	跑街	跑街	bau ka
跑鞋	跑鞋	跑鞋	bau gha
跑碼頭個	跑码头个	跑碼頭個	bau mo deu goq
跑單幫	跑单帮	跑單幫	bau tae paon
跑龍套個	跑龙套个	跑龍套個	bau lon thau goq
抱手	抱手	抱手	bau shieu
抱上轎	抱上轿	抱上轎	bau zaon jiau
暴	暴	暴	bau6
暴時	暴时	暴時	bau zy
暴生	暴生	暴生	bau san
莫	莫	莫	mhau1
莫	莫	莫	mau4
莫怕	莫怕	莫怕	mhau pho
莫怕	莫怕	莫怕	mau pho
毛	毛	毛	mau2
毛○	毛○	毛○	mau2
毛綫褲	毛线裤	毛線褲	mau shi khu
毛綫衫	毛线衫	毛線衫	mau shi sae
毛蟹	毛蟹	毛蟹	mau ha
毛毛雨	毛毛雨	毛毛雨	mau mau yu
毛毛蟲	毛毛虫	毛毛蟲	mau mau dzon
毛蚶	毛蚶	毛蚶	mau he
毛藍布	毛蓝布	毛藍布	mau lae pu
毛衫	毛衫	毛衫	mau sae
毛貨	毛货	毛貨	mau hou
毛頭奶花	毛头奶花	毛頭奶花	mau deu na hun
毛豆	毛豆	毛豆	mau deu
毛豆子	毛豆子	毛豆子	mau deu tsy
毛病	毛病	毛病	mau bin
毛巾	毛巾	毛巾	mau cin
毛巾絹帕	毛巾绢帕	毛巾絹帕	mau cin ciu phae
毛巾毯	毛巾毯	毛巾毯	mau cin thae
毛笋	毛笋	毛筍	mau syun
毛壓芋艿	毛压芋艿	毛壓芋艿	mau aq n na
毛腳女婿	毛脚女婿	毛腳女婿	mau ciaq gniu shi
毛竹	毛竹	毛竹	mau tsoq
毛穀籮頭	毛谷箩头	毛穀籮頭	mau koq lou deu
毛栗	毛栗	毛栗	mau liq
茅刀	茅刀	茅刀	mau tau
茅坑	茅坑	茅坑	mau khan
茅針	茅针	茅針	mau cin
卯	卯	卯	mau4
卯眼	卯眼	卯眼	mau ngae
冒	冒	冒	mau6
帽子	帽子	帽子	mau tsy
帽耳朵	帽耳朵	帽耳朵	mau gni to
帽耳朵	帽耳朵	帽耳朵	mau ng to
貓頭鹰	猫头鹰	貓頭鷹	mau deu in
刀	刀	刀	tau1
倒㼑	倒㼑	倒㼑	tau li
倒笡聳	倒笡耸	倒笡聳	tau chia son
倒爺笨	倒爷笨	倒爺笨	tau ya ben
倒竈	倒灶	倒竈	tau tsau
倒掛眉毛	倒挂眉毛	倒掛眉毛	tau kuo mi mau
倒掉	倒掉	倒掉	tau diau
倒翻	倒翻	倒翻	tau fae
倒拖	倒拖	倒拖	tau thou
倒大	倒大	倒大	tau dou
倒頭	倒头	倒頭	tau deu
倒宕木蓮	倒宕木莲	倒宕木蓮	tau dan moq li
倒陽	倒阳	倒陽	tau yan
倒運	倒运	倒運	tau yun
倒篤○	倒笃○	倒篤○	tau toq
倒篤○筋倒	倒笃○筋倒	倒篤○筋倒	tau toq cin tau
倒篤○和尚	倒笃○和尚	倒篤○和尚	tau toq ghou zaon
倒作	倒作	倒作	tau tsoq
倒皵皮	倒皵皮	倒皵皮	tau chiq bi
搗	捣	搗	tau3
搗子頭	捣子头	搗子頭	tau tsy deu
搗臼子	捣臼子	搗臼子	tau jieu tsy
搗蛋鬼	捣蛋鬼	搗蛋鬼	tau dae ciu
搗臼	捣臼	搗臼	tau jieu
捣鯁○	捣鲠○	搗鯁○	tau gan
搗門	捣门	搗門	tau men
搗親	捣亲	搗親	tau chin
擣地聾	捣地聋	搗地聾	tau di lon
到	到	到	tau5
到○	到○	到○	tau5
到底	到底	到底	tau ti
到介辰光	到介辰光	到介辰光	tau ka zyun kuaon
到靶	到靶	到靶	tau po
到門	到门	到門	tau men
討便宜	讨便宜	討便宜	thau bi gni
討意○房	讨意○房	討意○房	thau i vaon
討債	讨债	討債	thau tsa
討债鬼	讨债鬼	討債鬼	thau tsa ciu
討老婆	讨老婆	討老婆	thau lau bou
討價	讨价	討價	thau ko
討賬	讨账	討賬	thau cian
套	套	套	thau5
套鞋	套鞋	套鞋	thau gha
套裁	套裁	套裁	thau ze
套衫	套衫	套衫	thau sae
套間	套间	套間	thau kae
套盤圈	套盘圈	套盤圈	thau bun chiu
套結	套结	套結	thau ciq
逃○	逃○	逃○	dau2
逃娘婆	逃娘婆	逃娘婆	dau gnian bou
桃子	桃子	桃子	dau tsy
桃頭	桃头	桃頭	dau deu
桃子頭	桃子头	桃子頭	dau tsy deu
桃脯	桃脯	桃脯	dau phu
桃仁	桃仁	桃仁	dau gnin
桃紅	桃红	桃紅	dau ghon
陶成	陶成	陶成	dau jin
掏	掏	掏	dau2
掏井	掏井	掏井	dau cin
淘	淘	淘	dau2
淘梢	淘梢	淘梢	dau sau
淘簍	淘篓	淘簍	dau leu
淘湯飯	淘汤饭	淘湯飯	dau thaon vae
道	道	道	dau4
道士	道士	道士	dau zy
道地	道地	道地	dau di
道○搖○	道○摇○	道○搖○	dau yau
道頭	道头	道頭	dau deu
道伴	道伴	道伴	dau bun
稻	稻	稻	dau4
稻草	稻草	稻草	dau tshau
稻叉	稻叉	稻叉	dau tsho
稻大肚𡀂	稻大肚𡀂	稻大肚𡀂	dau dou du lei
稻頭	稻头	稻頭	dau deu
稻培○	稻培○	稻培○	dau bei
稻枚○	稻枚○	稻枚○	dau mei
稻桶	稻桶	稻桶	dau don
稻桶星	稻桶星	稻桶星	dau don shin
稻熟麻雀	稻熟麻雀	稻熟麻雀	dau zoq mo cian
稻桶麻雀	稻桶麻雀	稻桶麻雀	dau don mo cian
稻田麻雀	稻田麻雀	稻田麻雀	dau di mo cian
稻穀麻雀	稻谷麻雀	稻穀麻雀	dau koq moq cian
腦髓粉燥	脑髓粉燥	腦髓粉燥	nau shi fen sau
腦髓骨頭	脑髓骨头	腦髓骨頭	nau shi kuaq deu
骨頭腦髓	骨头脑髓	骨頭腦髓	kuaq deu nau shi
腦算	脑算	腦算	nau soe
腦頭	脑头	腦頭	nau deu
腦殼頭	脑壳头	腦殼頭	nau khoq deu
鬧○	闹○	鬧○	nau6
鬧新房	闹新房	鬧新房	nau shin vaon
鬧鐘	闹钟	鬧鐘	nau tson
閙熱	閙热	閙熱	nau gniq
撈	捞	撈	lhau1
牢	牢	牢	lau2
牢監	牢监	牢監	lau kae
牢監犯	牢监犯	牢監犯	lau kae vae
勞心	劳心	勞心	lau shin
勞作	劳作	勞作	lau tsoq
癆槽窞	痨槽窞	癆槽窞	lau zau dei
癆𤷾病	痨𤷾病	癆𤷾病	lau chiq bin
癆病	痨病	癆病	lau bin
老	老	老	lau4
老○	老○	老○	lau4
老鼠	老鼠	老鼠	lau tsy
老鼠奶奶	老鼠奶奶	老鼠奶奶	lau tsy nhe nhe
老鼠手	老鼠手	老鼠手	lau tsy shieu
老師	老师	老師	lau sy
老豬娘	老猪娘	老豬娘	lau tsyu gnian
老屁眼	老屁眼	老屁眼	lau phi ngae
老底子	老底子	老底子	lau ti tsy
老早子	老早子	老早子	lau tsau tsy
老早	老早	老早	lau tsau
老繭	老茧	老繭	lau ci
老氣	老气	老氣	lau chi
老先生	老先生	老先生	lau shi san
老鹽頭	老盐头	老鹽頭	lau yi deu
老布	老布	老布	lau pu
老虎	老虎	老虎	lau fu
老虎竈	老虎灶	老虎竈	lau fu tsau
老虎牙	老虎牙	老虎牙	lau fu ngo
老虎屙	老虎屙	老虎屙	lau fu ou
老虎窗	老虎窗	老虎窗	lau fu tshaon
老虎鉗	老虎钳	老虎鉗	lau fu ji
老土地	老土地	老土地	lau thu di
老鬼	老鬼	老鬼	lau ciu
老鬼三	老鬼三	老鬼三	lau ciu sae
老太婆	老太婆	老太婆	lau tha bou
老太婆	老太婆	老太婆	lau tha boe
老懈懈	老懈懈	老懈懈	lau ga ga
老蟹	老蟹	老蟹	lau ha
老爺	老爷	老爺	lau ya
老鴇	老鸨	老鴇	lau pau
老老	老老	老老	lau lau
老長	老长	老長	lau jian
老早	老早	老早	lau tsau
老早百裏	老早百里	老早百里	lau tsau paq li
老早百地	老早百地	老早百地	lau tsau paq di
老酵	老酵	老酵	lau kau
酵頭	酵头	酵頭	kau deu
老價鈿	老价钿	老價鈿	lau ko di
價格	价格	價格	ko kaq
老話頭	老话头	老話頭	lau wo deu
老鴉	老鸦	老鴉	lau o
老鴉臭	老鸦臭	老鴉臭	lau o chieu
老小無欺	老小无欺	老小無欺	lau shiau Wu chi
老花眼	老花眼	老花眼	lau huo ngae
老來	老来	老來	lau le
老K牌	老K牌	老K牌	lau khe bae
老K牌	老K牌	老K牌	lau khe ba
老板	老板	老闆	lau pae
老板娘	老板娘	老闆娘	lau pae gnian
老旦	老旦	老旦	lau tae
老三	老三	老三	lau sae
老三老四	老三老四	老三老四	lau sae lau sy
老三刮氣	老三刮气	老三刮氣	lau sae kuaq chi
老鴨	老鸭	老鴨	lau ae
老鴨	老鸭	老鴨	lau aq
老酒	老酒	老酒	lau cieu
老酒壺	老酒壶	老酒壺	lau cieu wu
老壺	老壶	老壺	lau wu
老酒窞窞	老酒窞窞	老酒窞窞	lau cieu dei dei
老酒甏	老酒甏	老酒甏	lau cieu ban
老酒包	老酒包	老酒包	lau cieu pau
老壽星頭	老寿星头	老壽星頭	lau zhieu shin deu
老油條	老油条	老油條	lau yeu diau
老婆	老婆	老婆	lau bou
老婆婆	老婆婆	老婆婆	lau bou bou
老婆兒囡	老婆儿囡	老婆兒囡	lau bou ng no
老大	老大	老大	lau dou
老大姑娘	老大姑娘	老大姑娘	lau dou ku gnian
老大小姐	老大小姐	老大小姐	lau dou shiau cia
老和尚過江暴	老和尚过江暴	老和尚過江暴	lau ghou zaon kou kaon pau
老頭	老头	老頭	lau deu
老頭	老头	老頭	lau dei
老頭汗衫	老头汗衫	老頭汗衫	lau deu ghEI sae
老頭汗衫	老头汗衫	老頭汗衫	lau dei ghEI sae
老頭伯	老头伯	老頭伯	lau deu pan
老頭伯	老头伯	老頭伯	lau dei pan
老頭子	老头子	老頭子	lau deu tsy
老頭子	老头子	老頭子	lau dei tsy
老口	老口	老口	lau kheu
老湯	老汤	老湯	lau thaon
老伯	老伯	老伯	lau pan
老伯伯	老伯伯	老伯伯	lau pan pan
老生	老生	老生	lau san
老槍	老枪	老槍	lau chian
老相好	老相好	老相好	lau shian hau
老相	老相	老相	lau shian
老相扮出	老相扮出	老相扮出	lau shian pae tshyuq
老門檻	老门槛	老門檻	lau men khae
老手	老手	老手	lau shieu
老孫兒子	老孙儿子	老孫兒子	lau sen ng tsy
老肯肯	老肯肯	老肯肯	lau khen khen
老縮縮	老缩缩	老縮縮	lau soq soq
老菱	老菱	老菱	lau lin
老成人	老成人	老成人	lau jin gnin
老鷹	老鹰	老鷹	lau in
老鷹抲小鷄	老鹰抲小鸡	老鷹抲小雞	lau in kho shiau ci
老鷹鼻頭管	老鹰鼻头管	老鷹鼻頭管	lau in baq deu kun
老笋頭	老笋头	老筍頭	lau syun deu
老公	老公	老公	lau kon
老公公	老公公	老公公	lau kon kon
老𡢿	老𡢿	老𡢿	lau gnion
老𡢿爿	老𡢿爿	老𡢿爿	lau gnion bae
老兄	老兄	老兄	lau shion
老白酒	老白酒	老白酒	lau baq cieu
老白蝨	老白虱	老白蝨	lau baq saq
老勿出	老勿出	老勿出	lau vaq tshyuq
老搭檔	老搭档	老搭檔	lau taq taon
老貼蛋	老贴蛋	老貼蛋	lau thaq dae
老拆○	老拆○	老拆○	lau tshaq
老伏卵	老伏卵	老伏卵	lau boq lou
老孵鷄	老孵鸡	老孵雞	lau bu ci
老木朧懂	老木胧懂	老木朧懂	lau moq lon ton
老木躘踵	老木𨀁踵	老木躘踵	lau moq lon tshon
老菔乾	老菔干	老菔乾	lau voq kI
老結	老结	老結	lau ciq
老十三	老十三	老十三	lau zyuq sae
老實頭	老实头	老實頭	lau zyuq deu
老實頭西	老实头西	老實頭西	lau zyuq deu shi
老實頭人	老实头人	老實頭人	lau zyuq deu gnin
爪	爪	爪	tsau3
搔癢	搔痒	搔癢	tsau yan
搔癢棒	搔痒棒	搔癢棒	tsau yan baon
遭眼	遭眼	遭眼	tsau ngae
糟	糟	糟	tsau1
糟手	糟手	糟手	tsau shieu
早	早	早	tsau3
早米	早米	早米	tsau mi
早瓠	早瓠	早瓠	tsau bu
早夜晚頭	早夜晚头	早夜晚頭	tsau ya mae deu
早稻	早稻	早稻	tsau dau
早稻時	早稻时	早稻時	tsau dau zy
早稻汛裏	早稻汛里	早稻汛裏	tsau dau shin li
早晏	早晏	早晏	tsau ae
早鱟	早鲎	早鱟	tsau heu
早兩年	早两年	早兩年	tsau lian gni
早半晌	早半晌	早半晌	tsau pun zaon
早春暴	早春暴	早春暴	tsau tshyun pau
早紅	早红	早紅	tsau ghon
早紅霞	早红霞	早紅霞	tsau ghon ya
早發人	早发人	早發人	tsau faq gnin
找○	找○	找○	tsau3
找○袖	找○袖	找○袖	tsau zhieu
找頭	找头	找頭	tsau dei
罩褲	罩裤	罩褲	tsau khu
罩衫	罩衫	罩衫	tsau sae
竈偏間	灶偏间	竈偏間	tsau phi kae
竈鷄	灶鸡	竈雞	tsau ci
竈前矮凳	灶前矮凳	竈前矮凳	tsau zhi a ten
竈頭	灶头	竈頭	tsau deu
竈頭桌凳	灶头桌凳	竈頭桌凳	tsau deu tsoq ten
竈頭地康○	灶头地康○	竈頭地康○	tsau deu di khaon
竈前地康○	灶前地康○	竈前地康○	tsau zhi di khaon
竈跟無賴	灶跟无赖	竈跟無賴	tsau ken vu la
竈跟間	灶跟间	竈跟間	tsau ken kae
竈間	灶间	竈間	tsau kae
竈跟	灶跟	竈跟	tsau ken
竈頭間	灶头间	竈頭間	tsau deu kae
竈洞	灶洞	竈洞	tsau don
竈屋洞	灶屋洞	竈屋洞	tsau oq don
竈洞眼	灶洞眼	竈洞眼	tsau don ngae
竈囱	灶囱	竈囪	tsau tshon
鈔票	钞票	鈔票	tshau phiau
操心思	操心思	操心思	tshau shin sy
吵朋	吵朋	吵朋	tshau ban
吵朋烏龜	吵朋乌龟	吵朋烏龜	tshau ban u ciu
吵房	吵房	吵房	tshau vaon
吵客	吵客	吵客	tshau khaq
炒豬肝	炒猪肝	炒豬肝	tshau tsyu kI
炒鷄蛋	炒鸡蛋	炒雞蛋	tshau ci dae
炒毛○麩	炒毛○麸	炒毛○麩	tshau mau fu
炒腰花	炒腰花	炒腰花	tshau iau huo
炒蝦仁	炒虾仁	炒蝦仁	tshau huo gnin
炒三絲	炒三丝	炒三絲	tshau sae sy
炒三鮮	炒三鲜	炒三鮮	tshau sae shi
炒冷飯	炒冷饭	炒冷飯	tshau lan vae
草	草	草	tshau3
草子	草子	草子	tshau tsy
草紙	草纸	草紙	tshau tsy
草字頭	草字头	草字頭	tshau zy deu
草墊子	草垫子	草墊子	tshau di tsy
草鷄	草鸡	草雞	tshau ci
草苫	草苫	草苫	tshau shi
草包	草包	草包	tshau pau
草帽	草帽	草帽	tshau mau
草稿	草稿	草稿	tshau kau
草窠	草窠	草窠	tshau khou
草棚	草棚	草棚	tshau ban
草棚棚	草棚棚	草棚棚	tshau ban ban
草上飛	草上飞	草上飛	tshau zaon fi
草青	草青	草青	tshau chin
草繩	草绳	草繩	tshau zhin
草蓬	草蓬	草蓬	tshau bon
草綠	草绿	草綠	tshau loq
草席	草席	草蓆	tshau zhiq
草魚	草鱼	草魚	tshau ng
耖田	耖田	耖田	tshau di
耖田邊	耖田边	耖田邊	tshau di pi
耖燥	耖燥	耖燥	tshau sau
糙	糙	糙	tshau5
糙拉拉	糙拉拉	糙拉拉	tshau lha lha
糙粒不剌	糙粒不剌	糙粒不剌	tshau liq paq laq
躁	躁	躁	tshau5
造大反	造大反	造大反	zau dou fae
造反	造反	造反	zau fae
捎	捎	捎	sau1
梢瓜	梢瓜	梢瓜	sau kuo
梢頭	梢头	梢頭	sau deu
筲	筲	筲	sau1
筲箕	筲箕	筲箕	sau ci
筲箕肚	筲箕肚	筲箕肚	sau ci du
騷屄	骚屄	騷屄	sau pi
掃垃圾個	扫垃圾个	掃垃圾個	sau la shi goq
掃帚	扫帚	掃帚	sau cieu
掃帚星	扫帚星	掃帚星	sau cieu shin
掃墓	扫墓	掃墓	sau mou
潲	潲	潲	sau5
燥	燥	燥	sau5
燥點心	燥点心	燥點心	sau ti shin
燥點心	燥点心	燥點心	sau te shin
燥地螞蟥	燥地蚂蟥	燥地螞蟥	sau di mo waon
燥地鴨	燥地鸭	燥地鴨	sau di ae
燥乎乎	燥乎乎	燥乎乎	sau fu fu
燥乎些色	燥乎些色	燥乎些色	sau fu shiq saq
燥淖泥	燥淖泥	燥淖泥	sau na gni
燥烤飯	燥烤饭	燥烤飯	sau khau vae
燥風水	燥风水	燥風水	sau fon syu
燥迫迫	燥迫迫	燥迫迫	sau paq paq
燥剝剝	燥剥剥	燥剝剝	sau poq poq
燥㬘	燥㬘	燥㬘	sau soq
燥燥㬘㬘	燥燥㬘㬘	燥燥㬘㬘	sau sau soq soq
燥𤿩𤿩	燥𤿩𤿩	燥𤿩𤿩	sau khoq khoq
漕嘴	漕嘴	漕嘴	zau tsyu
漕嘴頭	漕嘴头	漕嘴頭	zau tsyu deu
槽○鋤頭	槽○锄头	槽○鋤頭	zau zy deu
槽刨	槽刨	槽刨	zau bau
槽○槽○動	槽○槽○动	槽○槽○動	zau zau don
槽頭肉	槽头肉	槽頭肉	zau deu gnioq
造	造	造	zau6
造話	造话	造話	zau wo
造房子	造房子	造房子	zau vaon tsy
造孽	造孽	造孽	zau gniq
造孽頭朋	造孽头朋	造孽頭朋	zau gniq deu ban
造孽朋	造孽朋	造孽朋	zau gniq ban
造孽精	造孽精	造孽精	zau gniq cin
交老運	交老运	交老運	kau lau yun
交代勿過	交代勿过	交代勿過	kau de vaq kou
交秋	交秋	交秋	kau chieu
交運	交运	交運	kau yun
交春	交春	交春	kau tshyun
茭白	茭白	茭白	kau baq
高	高	高	kau1
高低牀	高低床	高低牀	kau ti zaon
高靴套鞋	高靴套鞋	高靴套鞋	kau shiu thau gha
高矮凳	高矮凳	高矮凳	kau a ten
高蹺	高跷	高蹺	kau chiau
高頭	高头	高頭	kau deu
高跟皮鞋	高跟皮鞋	高跟皮鞋	kau ken bi gha
高腳腳桶	高脚脚桶	高腳腳桶	kau ciaq ciaq don
高鑊蓋	高镬盖	高鑊蓋	kau ghoq ke
珓背	珓背	珓背	kau pei
教書先生	教书先生	教書先生	kau syu shi san
教方板	教方板	教方板	kau faon pae
膏	膏	膏	kau1
膏滋藥	膏滋药	膏滋藥	kau tsy yaq
膏蟹	膏蟹	膏蟹	kau ha
膏藥	膏药	膏藥	kau yaq
篙子	篙子	篙子	kau tsy
糕點	糕点	糕點	kau ti
糕糰庙	糕团庙	糕團廟	kau doe miau
絞	绞	絞	kau3
絞刀	绞刀	絞刀	kau tau
絞花被	绞花被	絞花被	kau huo bi
絞花子	绞花子	絞花子	kau huo tsy
絞腸痧	绞肠痧	絞腸痧	kau jian so
絞腸痛	绞肠痛	絞腸痛	kau jian thon
鉸鏈	铰链	鉸鏈	kau li
叫花子	叫花子	叫花子	kau huo tsy
告○	告○	告○	kau5
告○格	告○格	告○格	kau kaq
告示	告示	告示	kau zy
告訴	告诉	告訴	kau su
告吵儂𡀂	告吵侬𡀂	告吵儂𡀂	kau tshau nou lei
告狀	告状	告狀	kau zaon
校	校	校	kau5
酵頭	酵头	酵頭	kau deu
拷	拷	拷	khau1
拷火油箱	拷火油箱	拷火油箱	khau hou yeu shian
敲	敲	敲	khau1
敲扁橄欖	敲扁橄榄	敲扁橄欖	khau pi kae lae
敲地𡍲	敲地𡍲	敲地𡍲	khau di taq
敲瓦爿	敲瓦爿	敲瓦爿	khau ngo bae
敲花字	敲花字	敲花字	khau huo zy
敲背脊	敲背脊	敲背脊	khau pei ciq
敲大鑼	敲大锣	敲大鑼	khau dou lou
敲釘轉腳	敲钉转脚	敲釘轉腳	khau tin tsoe ciaq
敲定	敲定	敲定	khau din
敲木魚	敲木鱼	敲木魚	khau moq ng
敲𧰵	敲𧰵	敲𧰵	khau toq
考試	考试	考試	khau sy
考卷	考卷	考卷	khau ciu
考究	考究	考究	khau cieu
考場	考场	考場	khau jian
烤麩	烤麸	烤麩	khau fu
銬去	铐去	銬去	khau chi
靠…	靠…	靠…	khau5
靠墊	靠垫	靠墊	khau di
靠夜快	靠夜快	靠夜快	khau ya khua
靠腰身	靠腰身	靠腰身	khau iau shin
靠背	靠背	靠背	khau pei
靠背椅	靠背椅	靠背椅	khau pei i
靠背椅	靠背椅	靠背椅	khau pei iu
靠硬	靠硬	靠硬	khau ngan
鮳頭	鲓头	鮳頭	khau deu
薧頭	薧头	薧頭	khau deu
交	交	交	gau6
絞絲旁	绞丝旁	絞絲旁	gau sy baon
絞股	绞股	絞股	gau ku
絞隻	绞只	絞隻	gau tsaq
攪	搅	攪	gau4
攪嘴攪得	搅嘴搅得	攪嘴攪得	gau tsyu gau taq
攪腦子	搅脑子	攪腦子	gau nau tsy
攪軋	搅轧	攪軋	gau gaq
搞七搞八	搞七搞八	搞七搞八	gau chiq gau paq
搞依八𠡒	搞依八𠡒	搞依八𠡒	gau i paq tei
攪七八	搅七八	攪七八	gau chiq paq
熬	熬	熬	ngau2
咬	咬	咬	ngau4
咬奶頭	咬奶头	咬奶頭	ngau na deu
咬奶蒂頭	咬奶蒂头	咬奶蒂頭	ngau na ti deu
咬口	咬口	咬口	ngau kheu
咬勿動	咬勿动	咬勿動	ngau vaq don
咬勿落	咬勿落	咬勿落	ngau vaq loq
傲○	傲○	傲○	ngau6
痚駝病	痚驼病	痚駝病	hau dou bin
蒿蒿動	蒿蒿动	蒿蒿動	hau hau don
蒿菜	蒿菜	蒿菜	hau tshe
歊	歊	歊	hau1
好	好	好	hau3
好幾個	好几个	好幾個	hau ci goq
好幾個	好几个	好幾個	hau ci kou
好看	好看	好看	hau khI
好看鈿	好看钿	好看鈿	hau khI di
好壞	好坏	好壞	hau ua
好壞	好坏	好壞	hau wa
好好先生	好好先生	好好先生	hau hau shi san
好好叫	好好叫	好好叫	hau hau ciau
好好個	好好个	好好個	hau hau kou
好過	好过	好過	hau kou
好貨	好货	好貨	hau hou
好相量	好相量	好相量	hau shian lian
好甮	好甮	好甮	hau ven
好模好樣	好模好样	好模好樣	hau moq hau yan
好喫果子	好吃果子	好吃果子	hau chioq kou tsy
好日	好日	好日	hau gniq
好日酒	好日酒	好日酒	hau gniq cieu
好日黄狗	好日黄狗	好日黃狗	hau gniq waon kI
好嘸清頭	好呒清头	好嘸清頭	hau mh chin deu
孝子	孝子	孝子	hau tsy
孝杖棒	孝杖棒	孝杖棒	hau jian baon
孝杖棒頭	孝杖棒头	孝杖棒頭	hau jian baon deu
孝堂	孝堂	孝堂	hau daon
孝孫	孝孙	孝孫	hau sen
孝衾	孝衾	孝衾	hau chin
孝服	孝服	孝服	hau voq
哮管	哮管	哮管	hau kun
豪𢜶	豪𢜶	豪𢜶	ghau sau
噢	噢	噢	ghau2
壕溝	壕沟	壕溝	ghau keu
號頭	号头	號頭	ghau deu
嶴底	岙底	嶴底	au ti
嶴裏	岙里	嶴裏	au li
嶴口	岙口	嶴口	au kheu
䫜臉	䫜脸	䫜臉	au li
鏖糟	鏖糟	鏖糟	au tsau
鏖糟氣	鏖糟气	鏖糟氣	au tsau chi
鏖糟眼	鏖糟眼	鏖糟眼	au tsau ngae
拗	拗	拗	au3
拗嘴奪理	拗嘴夺理	拗嘴奪理	au tsyu daq li
拗軟骨	拗软骨	拗軟骨	au gniu kuaq
拗腰骨	拗腰骨	拗腰骨	au iau kuaq
拗手	拗手	拗手	au shieu
拗手勁	拗手劲	拗手勁	au shieu jin
拗斗	拗斗	拗鬥	au teu
拗腳馬	拗脚马	拗腳馬	au ciaq mo
詏	詏	詏	au3
懊惱	懊恼	懊惱	au nau
懊悶	懊闷	懊悶	au mhen
懊煞	懊煞	懊煞	au saq
燠	燠	燠	au5
巴弗能夠	巴弗能够	巴弗能夠	po faq nen keu
巴弗得	巴弗得	巴弗得	po faq taq
巴結	巴结	巴結	po ciq
芭蕉扇	芭蕉扇	芭蕉扇	po ciau shi
疤	疤	疤	po1
把	把	把	po3
把尿	把尿	把尿	po syu
把細	把细	把細	po shi
把戲	把戏	把戲	po shi
把家	把家	把家	po ko
把手	把手	把手	po shieu
把屙	把屙	把屙	po ou
把柄	把柄	把柄	po pin
把脈	把脉	把脈	po maq
把作	把作	把作	po tsoq
壩	坝	壩	po5
壩頭	坝头	壩頭	po deu
怕	怕	怕	pho5
怕势勢	怕势势	怕勢勢	pho syu syu
怕其	怕其	怕其	pho ji
怕敢	怕敢	怕敢	pho kI
怕權	怕权	怕權	pho jiu
怕生	怕生	怕生	pho san
怕光	怕光	怕光	pho kuaon
怕人	怕人	怕人	pho gnin
扒	扒	扒	bo2
爬起	爬起	爬起	bo chi
爬起來	爬起来	爬起來	bo chi le
耙	耙	耙	bo2
稗草	稗草	稗草	bo tshau
䶕	𫜨	䶕	bo6
䶕牙	𫜨牙	䶕牙	bo ngo
嬷嬷	嬷嬷	嬤嬤	mho mho
麻皮	麻皮	麻皮	mo bi
麻衣	麻衣	麻衣	mo i
麻酥糖	麻酥糖	麻酥糖	mo su daon
麻縞布	麻缟布	麻縞布	mo kau pu
麻油	麻油	麻油	mo yeu
麻糰	麻团	麻糰	mo doe
麻棗	麻枣	麻棗	mo tsau
麻口	麻口	麻口	mo kheu
麻將	麻将	麻將	mo cian
麻將牌	麻将牌	麻將牌	mo cian bae
麻雀	麻雀	麻雀	mo cian
麻餅	麻饼	麻餅	mo pin
麻筋	麻筋	麻筋	mo cin
麻繩	麻绳	麻繩	mo zhin
麻辣辣	麻辣辣	麻辣辣	mo laq laq
麻扎	麻扎	麻扎	mo tsaq
麻舌頭	麻舌头	麻舌頭	mo zhiq deu
麻骨	麻骨	麻骨	mo kuaq
𩞁餈	𩞁餈	𩞁餈	mo zyu
糯米𩞁餈	糯米𩞁餈	糯米𩞁餈	nou mi mo zyu
青𩞁餈	青𩞁餈	青𩞁餈	chin mo zyu
𣻕	𣻕	𣻕	mo2
馬	马	馬	mo4
馬嘴	马嘴	馬嘴	mo tsyu
馬屁	马屁	馬屁	mo phi
馬屁精	马屁精	馬屁精	mo phi cin
馬屁鬼	马屁鬼	馬屁鬼	ma phi ciu
馬面	马面	馬面	mo mi
馬路	马路	馬路	mo lu
馬路邊沿	马路边沿	馬路邊沿	mo lu pi yi
馬鲛魚	马鲛鱼	馬鮫魚	mo kau ng
馬褂	马褂	馬褂	mo kuo
馬蘭	马兰	馬蘭	mo lae
馬蘭頭	马兰头	馬蘭頭	mo lae deu
馬口鐵	马口铁	馬口鐵	mo kheu thiq
馬後炮	马后炮	馬後炮	mo gheu phau
馬桶	马桶	馬桶	mo don
馬桶箱	马桶箱	馬桶箱	mo don shian
馬桶豁筅	马桶豁筅	馬桶豁筅	mo don huaq shi
馬夾	马夹	馬夾	mo kaq
碼	码	碼	mo4
碼頭	码头	碼頭	mo deu
螞蟥	蚂蟥	螞蟥	mo waon
螞粉	蚂粉	螞粉	mo fen
螞轟○	蚂轰○	螞轟○	mo hon
螞蟻	蚂蚁	螞蟻	mo gni
朵	朵	朵	to3
朵拄	朵拄	朵拄	to tsyu
朵辮子	朵辫子	朵辮子	to bi tsy
朵開	朵开	朵開	to khe
朵○發	朵○发	朵○發	to faq
挆	挆	挆	to3
☐	☐	☐	tho3
☐底	☐底	☐底	tho ti
大家	大家	大家	do ko
囡疏○	囡疏○	囡疏○	no su
囡疏○	囡疏○	囡疏○	noe su
拿周	拿周	拿周	no cieu
拿穩	拿稳	拿穩	no uen
蚱𧐖	蚱𧐖	蚱𧐖	tso li
遮煞	遮煞	遮煞	tso saq
鷓鸪	鹧鸪	鷓鴣	tso ku
揸	揸	揸	tso3
炸豬排	炸猪排	炸豬排	tso tsyu ba
柞樹	柞树	柞樹	tso zyu
柞蠶	柞蚕	柞蠶	tso zei
搾	搾	搾	tso5
榨麵	榨面	榨面	tso mi
叉	叉	叉	tsho1
叉肩胛	叉肩胛	叉肩胛	tsho ci kaq
叉牌頭	叉牌头	叉牌頭	tsho ba deu
叉叉	叉叉	叉叉	tsho tsho
叉手袋	叉手袋	叉手袋	tsho shieu de
叉魚	叉鱼	叉魚	tsho ng
叉扁魚	叉扁鱼	叉扁魚	tsho pi ng
車	车	車	tsho1
車子裏	车子里	車子裏	tsho tsy li
車子前頭	车子前头	車子前頭	tsho tsy zhi deu
車子外頭	车子外头	車子外頭	tsho tsy nga deu
車子後頭	车子后头	車子後頭	tsho tsy gheu deu
車水	车水	車水	tsho syu
車票	车票	車票	tsho phiau
車板	车板	車板	tsho pae
車兜	车兜	車兜	tsho teu
車頭	车头	車頭	tsho deu
車行	车行	車行	tsho ghaon
差咋勿多	差咋勿多	差咋勿多	tsho dza vaq tou
差差	差差	差差	tsho tsho
差來浮去	差来浮去	差來浮去	tsho le vu chi
差扳	差扳	差扳	tsho pae
差	差	差	tsho1
差扳勿起	差扳勿起	差扳勿起	tsho pae vaq chi
差眼	差眼	差眼	tsho ngae
差扳眼	差扳眼	差扳眼	tsho pae ngae
差眼眼	差眼眼	差眼眼	tsho ngae ngae
差一眼	差一眼	差一眼	tsho iq ngae
差一眼眼	差一眼眼	差一眼眼	tsho iq ngae ngae
差勿多	差勿多	差勿多	tsho vaq tou
搓麻將	搓麻将	搓麻將	tsho mo cian
扯	扯	扯	tsho3
扯士	扯士	扯士	tsho zy
扯仕	扯仕	扯仕	tsho zy
扯布	扯布	扯布	tsho pu
扯蛋	扯蛋	扯蛋	tsho dae
扯老蛋	扯老蛋	扯老蛋	tsho lau dae
扯平	扯平	扯平	tsho bin
扯平	扯平	扯平	tsha bin
扯蓬	扯蓬	扯蓬	tsho bon
扯風蓬	扯风蓬	扯風蓬	tsho fon bon
岔路	岔路	岔路	tsho lu
岔翁○	岔翁○	岔翁○	tsho on
瘥	瘥	瘥	tsho5
茶	茶	茶	dzo2
茶水	茶水	茶水	dzo syu
茶樹	茶树	茶樹	dzo zyu
茶几	茶几	茶几	dzo ci
茶壺	茶壶	茶壺	dzo wu
茶花	茶花	茶花	dzo huo
茶手	茶手	茶手	dzo shieu
茶油	茶油	茶油	dzo yeu
茶杯	茶杯	茶杯	dzo pei
茶坊	茶坊	茶坊	dzo faon
茶房	茶房	茶房	dzo vaon
茶盤	茶盘	茶盤	dzo bun
茶碗	茶碗	茶碗	dzo un
茶風	茶风	茶風	dzo fon
茶農	茶农	茶農	dzo non
茶盅	茶盅	茶盅	dzo tson
茶腳	茶脚	茶腳	dzo ciaq
茶托	茶托	茶托	dzo thoq
茶葉	茶叶	茶葉	dzo yiq
茶葉茶	茶叶茶	茶葉茶	dzo yiq dzo
茶葉蛋	茶叶蛋	茶葉蛋	dzo yiq dae
查查廉廉	查查廉廉	查查廉廉	dzo dzo li li
查查問問	查查问问	查查問問	dzo dzo men men
蛇	蛇	蛇	dzo2
蛇皮癣	蛇皮癣	蛇皮癬	dzo bi shi
蛇籮	蛇箩	蛇籮	dzo lou
蛇吞○殼	蛇吞○壳	蛇吞○殼	dzo then khoq
蛇蟲百腳	蛇虫百脚	蛇蟲百腳	dzo dzon paq ciaq
搽	搽	搽	dzo2
搽藥膏	搽药膏	搽藥膏	dzo yaq kau
𤵾亂	𤵾乱	𤵾亂	dzo loe
沙○	沙○	沙○	so1
沙地	沙地	沙地	so di
沙泥地	沙泥地	沙泥地	so gni di
沙䥛	沙䥛	沙䥛	so ci
沙泥	沙泥	沙泥	so gni
沙胡嚨	沙胡咙	沙胡嚨	so wu lon
沙蟹	沙蟹	沙蟹	so ha
沙○沙○扳	沙○沙○扳	沙○沙○扳	so so pae
沙袋	沙袋	沙袋	so de
沙灘	沙滩	沙灘	so thae
沙灰	沙灰	沙灰	so huei
沙鍋	沙锅	沙鍋	so kou
沙頭	沙头	沙頭	so deu
舍頭	舍头	舍頭	so deu
砂鍋	砂锅	砂鍋	so kou
紗	纱	紗	so1
紗筛	纱筛	紗篩	so sy
紗窗	纱窗	紗窗	so tshaon
紗襪	纱袜	紗襪	so maq
啥地方	啥地方	啥地方	so di faon
啥地方	啥地方	啥地方	soq di faon
啥地方	啥地方	啥地方	sou di faon
啥犯着	啥犯着	啥犯着	so vae zyuq
啥犯着	啥犯着	啥犯着	sou vae zyuq
啥…式	啥…式	啥…式	so soq
啥…式	啥…式	啥…式	sou soq
啥…式	啥…式	啥…式	soq soq
稍勢	稍势	稍勢	so syu
稍爲	稍为	稍爲	so wei
稍便	稍便	稍便	so bi
痧藥	痧药	痧藥	so yaq
蓑衣	蓑衣	蓑衣	so i
賒賬	赊账	賒賬	so cian
射	射	射	zo6
惹	惹	惹	zo4
惹得得	惹得得	惹得得	zo taq taq
惹嫌	惹嫌	惹嫌	zo i
惹厭貓	惹厌猫	惹厭貓	zo i mae
瓜○	瓜○	瓜○	ko1
瓜子	瓜子	瓜子	kuo tsy
瓜子臉	瓜子脸	瓜子臉	kuo tsy li
瓜子盆	瓜子盆	瓜子盆	kuo tsy ben
瓜○瓜○	瓜○瓜○	瓜○瓜○	ko ko
瓜瓜鷄	瓜瓜鸡	瓜瓜雞	ko ko ci
加氣	加气	加氣	ko chi
加氣煩惱	加气烦恼	加氣煩惱	ko chi vae nau
加肉彩	加肉彩	加肉彩	ko gnioq tshe
家	家	家	ko1
家私	家私	傢俬	ko sy
家計	家计	家計	ko ci
家具店	家具店	傢俱店	ko jiu ti
家蛇	家蛇	家蛇	ko dzo
家小	家小	家小	ko shiau
家火	家火	家火	ko hou
家口	家口	家口	ko kheu
家生	家生	家生	ko san
家丁	家丁	家丁	ko tin
假癡假呆	假痴假呆	假癡假呆	ko tshyu ko nge
假癡假呆	假痴假呆	假癡假呆	ko tsyu ko nge
假癡假呆	假痴假呆	假癡假呆	ko tsy ko nge
假戲頭	假戏头	假戲頭	ko shi deu
假胡嚨	假胡咙	假胡嚨	ko wu lon
架	架	架	ko5
掛勢○	挂势○	掛勢○	kuo syu
掛錶	挂表	掛錶	kuo piau
嫁資	嫁资	嫁資	ko tsy
嫁衣	嫁衣	嫁衣	ko i
嫁妝	嫁妆	嫁妝	ko tsaon
嫁老公	嫁老公	嫁老公	ko lau kon
嫁男人	嫁男人	嫁男人	ko nEI gnin
嫁囡	嫁囡	嫁囡	ko noe
嫁人	嫁人	嫁人	ko gnin
價鈿	价钿	價鈿	ko di
抲	抲	抲	kho5
抲眉毛蟲	抲眉毛虫	抲眉毛蟲	kho mi mau dzon
抲去	抲去	抲去	kho chi
抲蟹	抲蟹	抲蟹	kho ha
抲筷	抲筷	抲筷	kho khuae
抲人車	抲人车	抲人車	kho gnin tsho
抲跌	抲跌	抲跌	kho tiq
抲魚	抲鱼	抲魚	kho ng
抲魚船	抲鱼船	抲魚船	kho ng zOE
㰤㰤	㰤㰤	㰤㰤	kho kho
☐☐	☐☐	☐☐	go go
☐☐𧮙	☐☐𧮙	☐☐𧮙	go go zoq
牙子	牙子	牙子	ngo tsy
牙子屙	牙子屙	牙子屙	ngo tsy ou
牙屙	牙屙	牙屙	ngo ou
牙子垽	牙子垽	牙子垽	ngo tsy gnin
牙子縫	牙子缝	牙子縫	ngo tsy von
牙鬚	牙须	牙鬚	ngo su
牙膏	牙膏	牙膏	ngo kau
牙盤	牙盘	牙盤	ngo bun
牙根	牙根	牙根	ngo ken
牙刷	牙刷	牙刷	ngo syuq
牙肉	牙肉	牙肉	ngo gnioq
蚜蟲	蚜虫	蚜蟲	ngo dzon
衙門	衙门	衙門	ngo men
瓦片	瓦片	瓦片	ngo phi
瓦刀	瓦刀	瓦刀	ngo tau
瓦爿	瓦爿	瓦爿	ngo bae
瓦爿灘	瓦爿滩	瓦爿灘	ngo bae thae
瓦流縫	瓦流缝	瓦流縫	ngo lieu von
瓦腔	瓦腔	瓦腔	ngo chian
瓦楞草	瓦楞草	瓦楞草	ngo len tshau
瓦屋	瓦屋	瓦屋	ngo oq
瓦粒	瓦粒	瓦粒	ngo liq
我	我	我	ngo4
我儂	我侬	我儂	ngo non
我個	我个	我個	ngo goq
我儂個	我侬个	我儂個	ngo nou goq
砑	砑	砑	ngo6
下	下	下	gho6
下麵	下面	下面	gho mi
下點心	下点心	下點心	gho ti shin
下點心	下点心	下點心	gho te shin
下世	下世	下世	gho shi
下霧露	下雾露	下霧露	gho Wu lu
下顧	下顾	下顧	gho ku
下擺	下摆	下襬	gho pa
下階沿	下阶沿	下階沿	gho ka yi
下遭	下遭	下遭	gho tsau
下回	下回	下回	gho wei
下毛○	下毛○	下毛○	gho mau
下巴	下巴	下巴	gho po
下巴饞	下巴馋	下巴饞	gho po zae
下巴兜	下巴兜	下巴兜	gho po teu
下巴骨	下巴骨	下巴骨	gho po kuaq
下家	下家	下家	gho ko
下飯	下饭	下飯	gho vae
下手	下手	下手	gho shieu
下辈	下辈	下輩	gho pei
下圍	下围	下圍	gho wei
下個月	下个月	下個月	gho kou yuq
下個月	下个月	下個月	gho goq yuq
下頭	下头	下頭	gho deu
下底	下底	下底	gho ti
下兩遭	下两遭	下兩遭	gho lian tsau
下兩回	下两回	下兩回	gho lian wei
下兩毛○	下两毛○	下兩毛○	gho lian mau
下槍○	下枪○	下槍○	gho chian
下一槍○	下一枪○	下一槍○	gho iq chian
下槍○裏	下枪○里	下槍○裏	gho chian li
下秧	下秧	下秧	gho ian
下種	下种	下種	gho tson
下横頭	下横头	下橫頭	gho wan deu
下首	下首	下首	gho shieu
下半年	下半年	下半年	gho pun gni
下半夜	下半夜	下半夜	gho pun ya
下半日	下半日	下半日	gho pun gniq
下半日頭	下半日头	下半日頭	gho pun gniq deu
下等人	下等人	下等人	gho ten gnin
下疄頭	下疄头	下疄頭	gho lin deu
下身	下身	下身	gho shin
下風頭	下风头	下風頭	gho fon deu
下弄上	下弄上	下弄上	gho lon zaon
下八腳	下八脚	下八腳	gho paq ciaq
下落	下落	下落	gho loq
下作	下作	下作	gho tsoq
下作坯子	下作坯子	下作坯子	gho tsoq phei tsy
下作貨	下作货	下作貨	gho tsoq hou
下日	下日	下日	gho gniq
夏至	夏至	夏至	gho tsy
夏天價	夏天价	夏天價	gho thi ko
丫臉	丫脸	丫臉	o li
丫臉犯落	丫脸犯落	丫臉犯落	o li vae loq
丫臉黑落	丫脸黑落	丫臉黑落	o li haq loq
丫臉捋落	丫脸捋落	丫臉捋落	o li laq loq
丫○碼○皮	丫○码○皮	丫○碼○皮	o mo bi
丫○碼○爿	丫○码○爿	丫○碼○爿	o mo bae
丫叉	丫叉	丫叉	o tsho
丫頭	丫头	丫頭	o deu
丫頭屄	丫头屄	丫頭屄	o deu pi
丫鵲	丫鹊	丫鵲	o chiaq
堊本○	垩本○	堊本○	o pen
搲	搲	搲	o1
搲船	搲船	搲船	o zOE
搲龍船	搲龙船	搲龍船	o lon zOE
啞子	哑子	啞子	o tsy
𦫪掉	𦫪掉	𦫪掉	o diau
𦫪色	𦫪色	𦫪色	o saq
掗	挜	掗	o5
掗賣豆腐	挜卖豆腐	掗賣豆腐	o ma deu vu
滮	滮	滮	piau1
表弟新婦	表弟新妇	表弟新婦	piau di shin vu
表姊妹	表姊妹	表姊妹	piau ci mei
表姐夫	表姐夫	表姐夫	piau cia fu
表妹夫	表妹夫	表妹夫	piau mei fu
表汗	表汗	表汗	piau ghEI
表親	表亲	表親	piau chin
表兄弟	表兄弟	表兄弟	piau shion di
表阿弟	表阿弟	表阿弟	piau aq di
表阿姐	表阿姐	表阿姐	piau aq cia
表阿嫂	表阿嫂	表阿嫂	piau aq sau
表阿妹	表阿妹	表阿妹	piau aq mei
表阿哥	表阿哥	表阿哥	piau aq kou
婊子	婊子	婊子	piau tsy
婊子兒子	婊子儿子	婊子兒子	piau tsy ng tsy
裱畫匠	裱画匠	裱畫匠	piau wo zhian
錶面	表面	表面	piau mi
錶鏈	表链	錶鏈	piau li
錶袋	表袋	表袋	piau de
飄○	飘○	飄○	phiau1
漂白	漂白	漂白	phiau baq
票	票	票	phiau5
票子	票子	票子	phiau tsy
票友	票友	票友	phiau yeu
漂亮	漂亮	漂亮	phiau lian
瓢	瓢	瓢	biau2
瓢蟲	瓢虫	瓢蟲	biau dzon
薸	薸	薸	biau2
瞄	瞄	瞄	mhiau1
苗	苗	苗	miau2
苗子	苗子	苗子	miau tsy
苗紅	苗红	苗紅	miau kon
苗繩	苗绳	苗繩	miau zhin
描	描	描	miau2
描紅簿	描红簿	描紅簿	miau ghon bu
廟會	庙会	廟會	miau wei
廟堂人	庙堂人	廟堂人	miau daon gnin
刁	刁	刁	tiau1
刁蠻	刁蛮	刁蠻	tiau mae
刁登○	刁登○	刁登○	tiau ten
釣魚	钓鱼	釣魚	tiau ng
釣魚竿	钓鱼竿	釣魚竿	tiau ng kI
釣魚鈎	钓鱼钩	釣魚鉤	tiau ng keu
雕	雕	雕	tiau1
雕花師父	雕花师父	雕花師父	tiau huo sy vu
窵角	窎角	窵角	tiau koq
鳥	鸟	鳥	tiau3
鳥窠	鸟窠	鳥窠	tiau khou
鳥頭	鸟头	鳥頭	tiau deu
鳥測字	鸟测字	鳥測字	tiau tshaq zy
吊	吊	吊	tiau5
吊水	吊水	吊水	tiau syu
吊水繩	吊水绳	吊水繩	tiau syu zhin
吊眼皮	吊眼皮	吊眼皮	tiau ngae bi
吊胃口	吊胃口	吊胃口	tiau wei kheu
吊梁桶	吊梁桶	吊樑桶	tiau lian don
吊膀子	吊膀子	吊膀子	tiau paon tsy
吊紅	吊红	吊紅	tiau ghon
吊襪帶	吊袜带	吊襪帶	tiau maq ta
吊煞鬼	吊煞鬼	吊煞鬼	tiau saq ciu
吊腳筋	吊脚筋	吊腳筋	tiau ciaq cin
挑	挑	挑	thiau1
挑痧氣	挑痧气	挑痧氣	thiau so chi
挑痧郎中	挑痧郎中	挑痧郎中	thiau so laon tson
挑擔	挑担	挑擔	thiau tae
挑手旁	挑手旁	挑手旁	thiau shieu baon
挑頭路	挑头路	挑頭路	thiau deu lu
挑貼皮	挑贴皮	挑貼皮	thiau thiaq bi
𣂁	𣂁	𣂁	thiau3
跳舞	跳舞	跳舞	thiau Wu
跳遠	跳远	跳遠	thiau yu
跳蚤	跳蚤	跳蚤	thiau tsau
跳高	跳高	跳高	thiau kau
跳板	跳板	跳板	thiau pae
跳河	跳河	跳河	thiau ghou
跳橡皮筋	跳橡皮筋	跳橡皮筋	thiau zhian bi cin
跳繩	跳绳	跳繩	thiau zhin
跳勿落	跳勿落	跳勿落	thiau vaq loq
跳角	跳角	跳角	thiau koq
跳穀麻雀	跳谷麻雀	跳穀麻雀	thiau koq mo cian
跳魚	跳鱼	跳魚	thiau ng
䠷頭王	䠷头王	䠷頭王	thiau deu waon
條	条	條	diau2
條子	条子	條子	diau tsy
條頭糕	条头糕	條頭糕	diau deu kau
條肉	条肉	條肉	diau gnioq
掉	掉	掉	diau6
調排	调排	調排	diau ba
調大	调大	調大	diau da
調調大大	调调大大	調調大大	diau diau da da
調覺	调觉	調覺	diau kau
調來換去	调来换去	調來換去	diau le wun chi
調頭	调头	調頭	diau deu
調頭𧝴角	调头𧝴角	調頭𧝴角	diau deu toq koq
調羹	调羹	調羹	diau kan
調槍花	调枪花	調槍花	diau chian huo
調匀	调匀	調勻	diau yun
調調匀匀	调调匀匀	調調勻勻	diau diau yun yun
調直	调直	調直	diau jiq
調調直直	调调直直	調調直直	diau diau jiq jiq
撩	撩	撩	liau2
撩起	撩起	撩起	liau chi
撩海	撩海	撩海	liau he
撩篩	撩筛	撩篩	liau sy
遼	辽	遼	liau2
遼形夾勢	辽形夹势	遼形夾勢	liau yin kaq syu
瞭高	瞭高	瞭高	liau kau
繚缴	缭缴	繚繳	liau ciau
䩍白	䩍白	䩍白	liau baq
了藤	了藤	了藤	liau den
了藤瓜	了藤瓜	了藤瓜	liau den kuo
料	料	料	liau6
料理	料理	料理	liau li
料車	料车	料車	liau tsho
料酒	料酒	料酒	liau cieu
料作	料作	料作	liau tsoq
料勺	料勺	料勺	liau zoq
料着	料着	料着	liau zyuq
交關	交关	交關	ciau kuae
交交關	交交关	交交關	ciau ciau kuae
交交關關	交交关关	交交關關	ciau ciau kuae kuae
交杯酒	交杯酒	交杯酒	ciau pei cieu
交杯盞	交杯盏	交杯盞	ciau pei tsae
招	招	招	ciau1
招牌	招牌	招牌	ciau ba
招寶山	招宝山	招寶山	ciau pau sae
招待	招待	招待	ciau de
招頭紙	招头纸	招頭紙	ciau deu tsy
招文袋	招文袋	招文袋	ciau ven de
招魂幡	招魂幡	招魂幡	ciau wen fae
招風耳朵	招风耳朵	招風耳朵	ciau fon ng to
招風耳朵	招风耳朵	招風耳朵	ciau fon gni to
焦	焦	焦	ciau1
焦瓦氣	焦瓦气	焦瓦氣	ciau ngo chi
焦黄	焦黄	焦黃	ciau waon
焦焦黄	焦焦黄	焦焦黃	ciau ciau waon
焦黄剌裏	焦黄剌里	焦黃剌裏	ciau waon laq li
焦得斯黄	焦得斯黄	焦得斯黃	ciau taq sy waon
膠菜	胶菜	膠菜	ciau tshe
澆水壺	浇水壶	澆水壺	ciau syu wu
澆便	浇便	澆便	ciau bi
澆頭	浇头	澆頭	ciau deu
澆○身	浇○身	澆○身	ciau shin
餃子	饺子	餃子	ciau tsy
叫	叫	叫	ciau5
叫扁○	叫扁○	叫扁○	ciau pi
叫子	叫子	叫子	ciau tsy
叫哥哥	叫哥哥	叫哥哥	ciau kou kou
叫春	叫春	叫春	ciau tshyun
教棒	教棒	教棒	ciau baon
照	照	照	ciau5
照面	照面	照面	ciau mi
照○面	照○面	照○面	ciau mi
照會	照会	照會	ciau wei
照相館	照相馆	照相館	ciau shian kun
照樣	照样	照樣	ciau yan
超	超	超	chiau1
繰	缲	繰	chiau1
繰貼皮	缲贴皮	繰貼皮	chiau thiaq bi
巧	巧	巧	chiau3
俏○俏○走	俏○俏○走	俏○俏○走	chiau chiau tseu
翘	翘	翹	chiau5
翘嘴	翘嘴	翹嘴	chiau tsyu
翘嘴鮊魚	翘嘴鲌鱼	翹嘴鮊魚	chiau tsyu ba ng
鮊魚	鲌鱼	鮊魚	ba ng
翘辮子	翘辫子	翹辮子	chiau bi tsy
翹牙鬚	翘牙须	翹牙鬚	chiau ngo su
翹翹板	翘翘板	翹翹板	chiau chiau pae
翘聳聳	翘耸耸	翹聳聳	chiau son son
蹺腳	跷脚	蹺腳	chiau ciaq
朝	朝	朝	jiau2
朝○	朝○	朝○	jiau2
朝裏	朝里	朝裏	jiau li
朝外	朝外	朝外	jiau nga
朝白笑	朝白笑	朝白笑	jiau baq shiau
朝口頭	朝口头	朝口頭	jiau kheu deu
朝日頭花	朝日头花	朝日頭花	jiau gniq deu huo
喬話	乔话	喬話	jiau wo
潮	潮	潮	jiau2
潮水	潮水	潮水	jiau syu
潮煙	潮烟	潮菸	jiau i
蕎頭	荞头	蕎頭	jiau deu
蕎麥	荞麦	蕎麥	jiau maq
橋頭三叔公	桥头三叔公	橋頭三叔公	jiau deu sae soq kon
橋頭老三	桥头老三	橋頭老三	jiau deu lau sae
撬	撬	撬	jiau6
撬○鋪	撬○铺	撬○鋪	jiau phu
撬軋	撬轧	撬軋	jiau gaq
撬䏘洞	撬䏘洞	撬䏘洞	jiau phiq don
轎子	轿子	轎子	jiau tsy
嘵豬	哓猪	嘵豬	gniau tsyu
饒	饶	饒	gniau2
繞繞頭	绕绕头	繞繞頭	gniau gniau deu
肖○	肖○	肖○	shiau1
肖蟹	肖蟹	肖蟹	shiau ha
消食	消食	消食	shiau zhiq
銷釘	销钉	銷釘	shiau tin
𢸳	𢸳	𢸳	shiau1
燒賣	烧卖	燒賣	shiau ma
燒窰個	烧窑个	燒窯個	shiau yau goq
燒酒	烧酒	燒酒	shiau cieu
燒酒楊梅	烧酒杨梅	燒酒楊梅	shiau cieu yan mei
燒火	烧火	燒火	shiau hou
燒火阿姆	烧火阿姆	燒火阿姆	shiau hou an m
燒香	烧香	燒香	shiau shian
小	小	小	shiau3
小囉嗦	小啰嗦	小囉嗦	shiau lou sou
小格楞敦	小格楞敦	小格楞敦	shiau kaq len ten
小指末頭	小指末头	小指末頭	shiau tsy maq deu
小字	小字	小字	shiau zy
小豬	小猪	小豬	shiau tsyu
小尿	小尿	小尿	shiau syu
小書	小书	小書	shiau syu
小暑	小暑	小暑	shiau syu
小便	小便	小便	shiau bi
小店	小店	小店	shiau ti
小姊妹道裏	小姊妹道里	小姊妹道里	shiau ci mei dau li
小鷄	小鸡	小雞	shiau ci
小氣	小气	小氣	shiau chi
小氣䏘	小气䏘	小氣䏘	shiau chi phiq
小年	小年	小年	shiau gni
小年夜	小年夜	小年夜	shiau gni ya
小姨	小姨	小姨	shiau yi
小肚	小肚	小肚	shiau du
小路	小路	小路	shiau lu
小姑	小姑	小姑	shiau ku
小苦	小苦	小苦	shiau khu
小胡桃	小胡桃	小胡桃	shiau wu dau
小胡嚨	小胡咙	小胡嚨	shiau wu lon
小鬼	小鬼	小鬼	shiau ciu
小鬼裏氣	小鬼里气	小鬼裏氣	shiau ciu li chi
小雨	小雨	小雨	shiau yu
小排	小排	小排	shiau ba
小矮凳	小矮凳	小矮凳	shiau a ten
小姐	小姐	小姐	shiau cia
小寫字	小写字	小寫字	shiau shia zy
小包車	小包车	小包車	shiau pau tsho
小毛頭	小毛头	小毛頭	shiau mau deu
小毛病	小毛病	小毛病	shiau mau bin
勿爽快	勿爽快	勿爽快	vaq saon khua
小搗臼	小捣臼	小搗臼	shiau tau jieu
小老嫌	小老嫌	小老嫌	shiau lau i
小吊碼子	小吊码子	小吊碼子	shiau tiau mo tsy
小條	小条	小條	shiau diau
小小人	小小人	小小人	shiau shiau gnin
小花臉	小花脸	小花臉	shiau huo li
小來	小来	小來	shiau le
小菜	小菜	小菜	shiau tshe
小菜場	小菜场	小菜場	shiau tshe jian
小開	小开	小開	shiau khe
小産	小产	小產	shiau tshae
小舢板	小舢板	小舢板	shiau sae pae
小鴨	小鸭	小鴨	shiau ae
小頑	小顽	小頑	shiau uae
小頑頭	小顽头	小頑頭	shiau uae deu
小囡	小囡	小囡	shiau noe
小輩	小辈	小輩	shiau pei
小寒	小寒	小寒	shiau ghEI
小鵝	小鹅	小鵝	shiau ngou
小火輪	小火轮	小火輪	shiau hou len
小貨閑話	小货闲话	小貨閒話	shiau hou ghae wo
小偷	小偷	小偷	shiau theu
小㪗卵	小㪗卵	小㪗卵	shiau theu loe
小頭	小头	小頭	shiau deu
小狗	小狗	小狗	shiau keu
小朋友	小朋友	小朋友	shiau ban yeu
小生	小生	小生	shiau san
小賬	小账	小賬	shiau cian
小腸	小肠	小腸	shiau jian
小腸氣	小肠气	小腸氣	shiau jian chi
小娘	小娘	小娘	shiau gnian
小娘屄	小娘屄	小娘屄	shiau gnian pi
小娘頭	小娘头	小娘頭	shiau gnian deu
小娘鬼	小娘鬼	小娘鬼	shiau gnian ciu
小娘蟹	小娘蟹	小娘蟹	shiau gnian ha
小娘阿姆	小娘阿姆	小娘阿姆	shiau gnian an m
小羊	小羊	小羊	shiau yan
小堂菜	小堂菜	小堂菜	shiau daon tshe
小堂名	小堂名	小堂名	shiau daon min
小糖	小糖	小糖	shiau daon
小黄魚	小黄鱼	小黃魚	shiau waon ng
小滿	小满	小滿	shiau mun
小官人	小官人	小官人	shiau kun gnin
小棺材	小棺材	小棺材	shiau kun ze
小襟	小襟	小襟	shiau cin
小人	小人	小人	shiau gnin
小小人	小小人	小小人	shiau shiau gnin
小籠包子	小笼包子	小籠包子	shiau lon pau tsy
小工	小工	小工	shiau kon
小八癩子	小八癞子	小八癩子	shiau paq la tsy
小八癩施○	小八癞施○	小八癩施○	shiau paq la sy
小白臉	小白脸	小白臉	shiau baq li
小白菜	小白菜	小白菜	shiau baq tshe
小麥	小麦	小麥	shiau maq
小赤佬	小赤佬	小赤佬	shiau tshaq lau
小腳褲	小脚裤	小腳褲	shiau ciaq khu
小腳鞋	小脚鞋	小腳鞋	shiau ciaq gha
小腳娘肚	小脚娘肚	小腳娘肚	shiau ciaq gnian du
小腳髈	小脚髈	小腳髈	shiau ciaq phaon
小桌凳	小桌凳	小桌凳	shiau tsoq ten
小雪	小雪	小雪	shiau syuq
小喫	小吃	小吃	shiau chioq
小癟三	小瘪三	小癟三	shiau piq sae
小結結	小结结	小結結	shiau ciq ciq
小練練	小练练	小練練	shiau li li
小熱昏	小热昏	小熱昏	shiau gniq huen
小舌頭	小舌头	小舌頭	shiau zhiq deu
小兒子	小儿子	小兒子	shiau ng tsy
曉得	晓得	曉得	shiau taq
少年白	少年白	少年白	shiau gni baq
少爺	少爷	少爺	shiau ya
孝子	孝子	孝子	shiau tsy
笑面虎	笑面虎	笑面虎	shiau mi fu
笑呵呵	笑呵呵	笑呵呵	shiau hou hou
紹興戲	绍兴戏	紹興戲	zhiau shin shi
搖	摇	搖	yau2
搖皮	摇皮	搖皮	yau bi
搖船	摇船	搖船	yau zOE
遙凌凌	遥凌凌	遙凌凌	yau lin lin
鷂子	鹞子	鷂子	yau tsy
妖怪精	妖怪精	妖怪精	iau kua cin
妖形怪狀	妖形怪状	妖形怪狀	iau yin kua dzaon
腰	腰	腰	iau1
腰子	腰子	腰子	iau tsy
腰子病	腰子病	腰子病	iau tsy bin
腰鼓腳	腰鼓脚	腰鼓腳	iau ku ciaq
腰花	腰花	腰花	iau huo
腰縛	腰缚	腰縛	iau bou
腰身	腰身	腰身	iau shin
舀	舀	舀	iau3
舀湯	舀汤	舀湯	iau thaon
闄	闄	闄	iau3
闄折	闄折	闄折	iau ciq
闄折門	闄折门	闄折門	iau ciq men
要鈿嘸郎	要钿呒郎	要鈿嘸郎	iau di mh laon
要好	要好	要好	iau hau
要儂𢜭力𡀂	要侬𢜭力𡀂	要儂𢜭力𡀂	iau nou jiaq liq lei
要緊	要紧	要緊	iau cin
要緊要慢	要紧要慢	要緊要慢	iau cin iau mae
花	花	花	huo1
花師父	花师父	花師父	huo sy vu
花覷眼	花觑眼	花覷眼	huo tshyu ngae
花邊	花边	花邊	huo pi
花皮脆瓜	花皮脆瓜	花皮脆瓜	huo bi tshei kuo
花被	花被	花被	huo bi
花癲	花癫	花癲	huo ti
花癲大糊	花癫大糊	花癲大糊	huo ti da wu
花店	花店	花店	huo ti
花蓮菜	花莲菜	花蓮菜	huo li tshe
花裏花綳	花里花绷	花裏花繃	huo li huo pan
花旗蜜橘	花旗蜜橘	花旗蜜橘	huo ji miq ciuq
花呢	花呢	花呢	huo gni
花絮	花絮	花絮	huo shi
花稈	花秆	花稈	huo kI
花露水	花露水	花露水	huo lu syu
花卷	花卷	花捲	huo ciu
花蕊頭	花蕊头	花蕊頭	huo gniu deu
花園洋房	花园洋房	花園洋房	huo yu yan vaon
花泡	花泡	花泡	huo phau
花毛衣	花毛衣	花毛衣	huo mau i
花佬	花佬	花佬	huo lau
花佬瓶阿七	花佬瓶阿七	花佬瓶阿七	huo lau bin aq chiq
花佬兒子	花佬儿子	花佬兒子	huo lau ng tsy
花彫	花雕	花雕	huo tiau
花椒	花椒	花椒	huo ciau
花轎	花轿	花轎	huo jiau
花花公子	花花公子	花花公子	huo huo kon tsy
花菜	花菜	花菜	huo tshe
花旦	花旦	花旦	huo tae
花磚地板	花砖地板	花磚地板	huo tsoe di pae
花頭	花头	花頭	huo deu
花頭花腦	花头花脑	花頭花腦	huo deu huo nau
花頭透○	花头透○	花頭透○	huo deu theu
花樣精	花样精	花樣精	huo yan cin
花頭精	花头精	花頭精	huo deu cin
花紋酒	花纹酒	花紋酒	huo ven cieu
花生	花生	花生	huo sen
花生米	花生米	花生米	huo sen mi
花生醬	花生酱	花生醬	huo sen cian
花生糖	花生糖	花生糖	huo sen daon
花心子	花心子	花心子	huo shin tsy
花心	花心	花心	huo shin
花筒	花筒	花筒	huo don
花紅	花红	花紅	huo ghon
花蛤	花蛤	花蛤	huo kaq
花綠紙	花绿纸	花綠紙	huo loq tsy
花燭夫妻	花烛夫妻	花燭夫妻	huo tsoq fu chi
花葉辦	花叶办	花葉辦	huo yiq bae
呵	呵	呵	huo1
呵酣	呵酣	呵酣	huo he
呵癢趣趣	呵痒趣趣	呵癢趣趣	huo yan tshyu tshyu
蝦	虾	蝦	huo3
蝦子	虾子	蝦子	huo tsy
蝦子醬油	虾子酱油	蝦子醬油	huo tsy cian yeu
蝦皮	虾皮	蝦皮	huo bi
蝦皮彈蟲	虾皮弹虫	蝦皮彈蟲	huo bi dae dzon
蝦蛄彈	虾蛄弹	蝦蛄彈	huo ku dae
蝦米	虾米	蝦米	huo mi
蝦乾	虾干	蝦乾	huo kI
蝦⿸虫孱	虾⿸虫孱	蝦⿸虫孱	huo zae
蝦段	虾段	蝦段	huo doe
蝦醬	虾酱	蝦醬	huo cian
蝦仁	虾仁	蝦仁	huo gnin
蝦紅	虾红	蝦紅	huo ghon
煆	煆	煆	huo5
鏵鍬	铧锹	鏵鍬	wo chiau
畫境綫	画境线	畫境線	wo cin shi
話	话	話	wo6
話李	话李	話李	wo li
話把	话把	話把	wo po
話梅	话梅	話梅	wo mei
話頭	话头	話頭	wo deu
話柄	话柄	話柄	wo pin
話勿睬	话勿睬	話勿睬	wo vaq tshe
話勿理睬	话勿理睬	話勿理睬	wo vaq li tshe
話勿出	话勿出	話勿出	wo vaq tshyuq
話劇	话剧	話劇	wo jiq
蛙泳	蛙泳	蛙泳	uo ion
☐	☐	☐	uo5
𧟰	𧟰	𧟰	fe1
𧟰渠	𧟰渠	𧟰渠	fe ji
點心時	点心时	點心時	te shin zy
戴頭蓬	戴头蓬	戴頭蓬	te deu bon
胎記	胎记	胎記	the ci
胎裏記認	胎里记认	胎裏記認	the li ci gnin
胎髮	胎发	胎髮	the faq
☐	☐	☐	the3
☐鬆	☐松	☐鬆	the son
苔條	苔条	苔條	de diau
苔條油饡子	苔条油饡子	苔條油饡子	de diau yeu tsae tsy
苔條拖黄魚	苔条拖黄鱼	苔條拖黃魚	de diau thou waon ng
苔條餅	苔条饼	苔條餅	de diau pin
苔生片	苔生片	苔生片	de sen phi
抬	抬	擡	de2
抬去	抬去	擡去	de chi
抬意○房	抬意○房	擡意○房	de i vaon
抬老𡢿	抬老𡢿	擡老𡢿	de lau gnion
抬老婆	抬老婆	擡老婆	de lau bou
抬轎大皮	抬轿大皮	擡轎大皮	de jiau dou bi
抬轎郎	抬轿郎	擡轎郎	de jiau laon
抬抬動	抬抬动	擡擡動	de de don
抬頭	抬头	擡頭	de deu
抬城隍	抬城隍	擡城隍	de jin waon
抬新婦	抬新妇	擡新婦	de shin vu
臺布	台布	檯布	de pu
臺虎鉗	台虎钳	臺虎鉗	de fu ji
臺型	台型	臺型	de yin
臺鐘	台钟	檯鐘	de tson
代書	代书	代書	de syu
待筵	待筵	待筵	de yi
怠慢	怠慢	怠慢	de mae
玳玳花	玳玳花	玳玳花	de de huo
袋	袋	袋	de6
袋皮	袋皮	袋皮	de bi
袋袋	袋袋	袋袋	de de
袋衫	袋衫	袋衫	de sae
奶奶	奶奶	奶奶	nhe nhe
奶奶脯	奶奶脯	奶奶脯	nhe nhe bu
奶脯	奶脯	奶脯	nhe bu
奶奶頭	奶奶头	奶奶頭	nhe nhe deu
廿	廿	廿	nE6
廿外	廿外	廿外	nE nga
廿九夜	廿九夜	廿九夜	nE cieu ya
廿一	廿一	廿一	nE iq
廿二	廿二	廿二	nE gni
廿三	廿三	廿三	nE sae
廿四	廿四	廿四	nE sy
廿五	廿五	廿五	nE ng
廿六	廿六	廿六	nE loq
廿七	廿七	廿七	nE chiq
廿八	廿八	廿八	nE paq
廿九	廿九	廿九	nE cieu
念○年子	念○年子	念○年子	nE gni tsy
念○年	念○年	念○年	nE gni
念○嬉䏘	念○嬉䏘	念○嬉䏘	nE shi phiq
念○嬉殺	念○嬉杀	念○嬉殺	nE shi saq
念阿彌陀佛	念阿弥陀佛	唸阿彌陀佛	nE o mi dou vaq
念經	念经	唸經	nE cin
念伴	念伴	唸伴	nE bun
念先生	念先生	唸先生	nE shi san
念佛個	念佛个	唸佛個	nE vaq goq
耐心耐相	耐心耐相	耐心耐相	ne shin ne shian
罱河泥	罱河泥	罱河泥	ne ghou gni
來	来	來	le2
來勒	来勒	來勒	le laq
來的	来的	來的	le tiq
來該	来该	來該	le ke
來當	来当	來當	le taon
來東	来东	來東	le ton
來的𡀂	来的𡀂	來的𡀂	le tiq lei
再三再四	再三再四	再三再四	tse sae tse sy
再…嘸没𡀂	再…呒没𡀂	再…嘸沒𡀂	tse mhiq lei
猜烏字	猜乌字	猜烏字	tshe u zy
猜謎子	猜谜子	猜謎子	tshe mei tsy
睬儂瞎子	睬侬瞎子	睬儂瞎子	tshe nou haq tsy
睬儂老白眼	睬侬老白眼	睬儂老白眼	tshe nou lau baq ngae
睬儂瞎子老白眼	睬侬瞎子老白眼	睬儂瞎子老白眼	tshe nou haq tsy lau baq ngae
睬儂阿白哥	睬侬阿白哥	睬儂阿白哥	tshe nou aq baq kou
睬渠瞎子	睬渠瞎子	睬渠瞎子	tshe ji haq tsy
睬渠老白眼	睬渠老白眼	睬渠老白眼	tshe ji lau baq ngae
睬渠瞎子老白眼	睬渠瞎子老白眼	睬渠瞎子老白眼	tshe ji haq tsy lau baq ngae
睬渠阿白哥	睬渠阿白哥	睬渠阿白哥	tshe ji aq baq kou
睬我瞎子	睬我瞎子	睬我瞎子	tshe ngo haq tsy
睬我老白眼	踩我老白眼	睬我老白眼	tshe ngo lau baq ngae
睬我瞎子老白眼	睬我瞎子老白眼	睬我瞎子老白眼	tshe ngo haq tsy lau baq ngae
睬我阿白哥	睬我阿白哥	睬我阿白哥	tshe ngo aq baq kou
睬俉瞎子	睬俉瞎子	睬俉瞎子	tshe ng haq tsy
睬俉老白眼	睬俉老白眼	睬俉老白眼	tshe ng lau baq ngae
睬俉瞎子老白眼	睬俉瞎子老白眼	睬俉瞎子老白眼	tshe ng haq tsy lau baq ngae
睬俉阿白哥	睬俉阿白哥	睬俉阿白哥	tshe ng aq baq kou
彩蛋	彩蛋	彩蛋	tshe dae
菜籽	菜籽	菜籽	tshe tsy
菜地	菜地	菜地	tshe di
菜蒲絡頭	菜蒲络头	菜蒲絡頭	tshe bu loq deu
菜瓜	菜瓜	菜瓜	tshe kuo
菜椒	菜椒	菜椒	tshe ciau
菜花蛇	菜花蛇	菜花蛇	tshe huo dzo
菜油	菜油	菜油	tshe yeu
菜心	菜心	菜心	tshe shin
菜蟲	菜虫	菜蟲	tshe dzon
菜蕻	菜蕻	菜蕻	tshe hon
菜蕻乾	菜蕻干	菜蕻乾	tshe hon kI
菜綠	菜绿	菜綠	tshe loq
菜葉爿	菜叶爿	菜葉爿	tshe yiq bae
啐	啐	啐	tshe5
財神菩薩	财神菩萨	財神菩薩	dze zyun bu saq
財百萬	财百万	財百萬	dze paq vae
在行	在行	在行	dze ghaon
在行三叔婆	在行三叔婆	在行三叔婆	dze ghaon sae soq bou
帥	帅	帥	se5
赛球	赛球	賽球	se jieu
赛過	赛过	賽過	se kou
裁○	裁○	裁○	ze2
裁片	裁片	裁片	ze phi
裁縫	裁缝	裁縫	ze von
裁縫師父	裁缝师父	裁縫師父	ze von sy vu
裁縫店	裁缝店	裁縫店	ze von ti
𡨢	𡨢	𡨢	ke1
𡨢	𡨢	𡨢	kI1
該	该	該	ke1
該死	该死	該死	ke shi
改教	改教	改教	ke ciau
蓋頭	盖头	蓋頭	ke deu
蓋捫碗	盖扪碗	蓋捫碗	ke men un
開水	开水	開水	khe syu
開面	开面	開面	khe mi
開面酒	开面酒	開面酒	khe mi cieu
開店	开店	開店	khe ti
開普帽	开普帽	開普帽	khe phu mau
開步	开步	開步	khe bu
開太陽	开太阳	開太陽	khe tha yan
開庎櫥門	开庎橱门	開庎櫥門	khe ka dzyu men
開夜車	开夜车	開夜車	khe ya tsho
開衩	开衩	開衩	khe tsho
開骻	开骻	開骻	khe khuo
開銷	开销	開銷	khe shiau
開飯	开饭	開飯	khe vae
開衫	开衫	開衫	khe sae
開眼烏龜	开眼乌龟	開眼烏龜	khe ngae u ciu
開伙倉	开伙仓	開伙倉	khe hou tshaon
開口	开口	開口	khe kheu
開張	开张	開張	khe cian
開場	开场	開場	khe jian
開洋	开洋	開洋	khe yan
開方子	开方子	開方子	khe faon tsy
開藥方	开药方	開藥方	khe yaq faon
開庭	开庭	開庭	khe din
開心	开心	開心	khe shin
開葷	开荤	開葷	khe huen
開春	开春	開春	khe tshyun
開豁	开豁	開豁	khe huaq
開雪眼	开雪眼	開雪眼	khe syuq ngae
開缺頭	开缺头	開缺頭	khe chiuq deu
看	看	看	khe5
墈	墈	墈	khe5
䬵	䬵	䬵	ge6
隑	隑	隑	ge4
隑絲	隑丝	隑絲	ge sy
隑牌頭	隑牌头	隑牌頭	ge ba deu
隑勢道	隑势道	隑勢道	ge syu dau
隑白皮	隑白皮	隑白皮	ge baq bi
戤叉	戤叉	戤叉	ge tsho
戤糖碗	戤糖碗	戤糖碗	ge daon un
戤鈸	戤钹	戤鈸	ge baq
戤馱○鈸	戤驮○钹	戤馱○鈸	ge dou baq
戤尺板	戤尺板	戤尺板	ge tshaq pae
呆	呆	呆	nge2
呆性性	呆性性	呆性性	nge shin shin
呆剝剝	呆剥剥	呆剝剝	nge poq poq
呆古古	呆古古	呆古古	nge ku ku
呆的剝落	呆的剥落	呆的剝落	nge tiq poq loq
呆剝𢙱倲	呆剥𢙱㑈	呆剝𢙱倲	nge poq lon ton
呆大	呆大	呆大	nge dou
呆大樸	呆大朴	呆大樸	nge dou phoq
呆大女婿	呆大女婿	呆大女婿	nge dou gniu shi
呆大刮氣	呆大刮气	呆大刮氣	nge dou kuaq chi
呆大兒子	呆大儿子	呆大兒子	nge dou ng tsy
呆頭呆腦	呆头呆脑	呆頭呆腦	nge deu nge nau
呆長呆大	呆长呆大	呆長呆大	nge jian nge dou
艾	艾	艾	nge6
隑	隑	隑	nge4
蚶子	蚶子	蚶子	he tsy
蚶子口棉鞋	蚶子口棉鞋	蚶子口棉鞋	he tsy kheu mi gha
海	海	海	he3
海子碗	海子碗	海子碗	he tsy un
海鮮	海鲜	海鮮	he shi
海蜒	海蜒	海蜒	he yi
海夫絨	海夫绒	海夫絨	he fu gnion
海帶	海带	海帶	he ta
海老鷹	海老鹰	海老鷹	he lau in
海瓜子	海瓜子	海瓜子	he kuo tsy
海威	海威	海威	he uei
海棠	海棠	海棠	he daon
海棠糕	海棠糕	海棠糕	he daon kau
海棠果	海棠果	海棠果	he daon kou
海參	海参	海蔘	he sen
海冬青	海冬青	海冬青	he ton chin
海蜇	海蜇	海蜇	he ciq
海蜇皮子	海蜇皮子	海蜇皮子	he ciq bi tsy
海蜇頭	海蜇头	海蜇頭	he ciq deu
許	许	許	he5
許願心	许愿心	許願心	he gniu shin
漢郎頭	汉郎头	漢郎頭	he laon deu
亥	亥	亥	ghe4
咳	咳	咳	ghe4
愛惜	爱惜	愛惜	e shiq
茄	茄	茄	jie2
班	班	班	pae1
班長	班长	班長	pae cian
斑毛	斑毛	斑毛	pae mau
斑鳩	斑鸠	斑鳩	pae cieu
瘢疤	瘢疤	瘢疤	pae po
板	板	板	pae3
板篩	板筛	板篩	pae sy
板板六十四	板板六十四	板板六十四	pae pae loq zyuq sy
板眼	板眼	板眼	pae ngae
板油	板油	板油	pae yeu
板規	板规	板規	pae kuei
板定	板定	板定	pae din
板箱	板箱	板箱	pae shian
板牀	板床	板牀	pae zaon
板仄	板仄	板仄	pae tsaq
板壁	板壁	板壁	pae piq
板刷	板刷	板刷	pae syuq
板鋤	板锄	板鋤	pae zy
扳叉頭	扳叉头	扳叉頭	pae tsho deu
扳價鈿	扳价钿	扳價鈿	pae ko di
扳位	扳位	扳位	pae wei
扳後腳	扳后脚	扳後腳	pae gheu ciaq
扳腳後跟	扳脚后跟	扳腳後跟	pae ciaq gheu ken
扮相	扮相	扮相	pae shian
𢲔	𢲔	𢲔	pae5
𢲔跌	𢲔跌	𢲔跌	pae tiq
攀	攀	攀	phae1
攀親	攀亲	攀親	phae chin
襻頭	襻头	襻頭	phae deu
爿	爿	爿	bae2
𨂝	𨂝	𨂝	bae6
辦事體	办事体	辦事體	bae zy thi
辦移交	办移交	辦移交	bae yi ciau
辦酒水	办酒水	辦酒水	bae cieu syu
辦酒窠	办酒窠	辦酒窠	bae cieu khou
辦公桌	办公桌	辦公桌	bae kon tsoq
蠻	蛮	蠻	mhae1
蠻氣	蛮气	蠻氣	mae chi
蠻長蠻大	蛮长蛮大	蠻長蠻大	mae jian mae dou
蠻人	蛮人	蠻人	mae gnin
咩咩羊	咩咩羊	咩咩羊	mhae mhae yan
晚米	晚米	晚米	mae mi
晚爹	晚爹	晚爹	mae tia
晚稻時	晚稻时	晚稻時	mae dau zy
晚稻汛裏	晚稻汛里	晚稻汛裏	mae dau shin li
晚頭	晚头	晚頭	mae deu
晚娘	晚娘	晚娘	mae gnian
晚青	晚青	晚青	mae chin
晚稻	晚稻	晚稻	mae dau
萬子	万子	萬子	mae tsy
慢太婆	慢太婆	慢太婆	mae tha bou
慢慢叫	慢慢叫	慢慢叫	mae mae ciau
慢慢走	慢慢走	慢慢走	mae mae tseu
慢慢喫	慢慢吃	慢慢吃	mae mae chioq
慢泛	慢泛	慢泛	mae fae
慢☐☐	慢☐☐	慢☐☐	mae than than
貓	猫	貓	mae6
番薯	番薯	番薯	fae zyu
番薯乾	番薯干	番薯乾	fae zyu kI
番薯糊辣	番薯糊辣	番薯糊辣	fae zyu wu laq
番薯癟	番薯瘪	番薯癟	fae zyu piq
番薯片	番薯片	番薯片	fae zyu phi
番薯錫	番薯锡	番薯錫	fae zyu shiq
番茄	番茄	番茄	fae ga
番茄醬	番茄酱	番茄醬	fae ga cian
翻	翻	翻	fae1
翻天山	翻天山	翻天山	fae thi sae
翻地角落頭	翻地角落头	翻地角落頭	fae di koq loq deu
翻大向	翻大向	翻大向	fae dou shian
翻行頭	翻行头	翻行頭	fae ghaon deu
翻向	翻向	翻向	fae shian
翻筋倒	翻筋倒	翻筋倒	fae cin tau
翻頂倒	翻顶倒	翻頂倒	fae tin tau
翻白	翻白	翻白	fae baq
翻白泥螺	翻白泥螺	翻白泥螺	fae baq gni lou
翻落	翻落	翻落	fae loq
反犬旁	反犬旁	反犬旁	fae chiu baon
反背	反背	反背	fae pei
反向	反向	反向	fae shian
反使	反使	反使	fae sy
反門襟	反门襟	反門襟	fae men cin
反文旁	反文旁	反文旁	fae ven baon
反格	反格	反格	fae kaq
反則	反则	反則	fae tsaq
泛	泛	泛	fae5
泛○	泛○	泛○	fae5
泛○登○	泛○登○	泛○登○	fae ten
㽹	㽹	㽹	fae5
帆布椅	帆布椅	帆布椅	vae pu i
帆布椅	帆布椅	帆布椅	vae pu iu
帆布矮凳	帆布矮凳	帆布矮凳	vae pu a ten
帆布凳	帆布凳	帆布凳	vae pu ten
帆布牀	帆布床	帆布牀	vae pu zaon
煩	烦	煩	vae2
煩比牢糟	烦比牢糟	煩比牢糟	vae pi lau tsau
煩難	烦难	煩難	vae nae
煩雜	烦杂	煩雜	vae dzaq
犯天打	犯天打	犯天打	vae thi tan
犯賤	犯贱	犯賤	vae zhi
犯關	犯关	犯關	vae kuae
犯對	犯对	犯對	vae tei
犯夜	犯夜	犯夜	vae ya
犯盎○	犯盎○	犯盎○	vae aon
犯人	犯人	犯人	vae gnin
犯人車	犯人车	犯人車	vae gnin tsho
犯法	犯法	犯法	vae faq
犯罪	犯罪	犯罪	vae zei
犯着	犯着	犯着	vae zyuq
飯	饭	飯	vae6
飯師父	饭师父	飯師父	vae sy vu
飯頭腦	饭头脑	飯頭腦	vae deu nau
飯店	饭店	飯店	vae ti
飯黏	饭黏	飯黏	vae kni
飯烏龜	饭乌龟	飯烏龜	vae u ciu
飯盂	饭盂	飯盂	vae yu
飯包	饭包	飯包	vae pau
飯瓜	饭瓜	飯瓜	vae kuo
飯𣖄	饭𣖄	飯𣖄	vae chiau
飯瓢	饭瓢	飯瓢	vae biau
飯翘骨	饭翘骨	飯翹骨	vae chiau kuaq
飯單	饭单	飯單	vae tae
飯單襟	饭单襟	飯單襟	vae tae cin
飯籃	饭篮	飯籃	vae lae
飯筲箕	饭筲箕	飯筲箕	vae sau ci
飯籃筲箕	饭篮筲箕	飯籃筲箕	vae lae sau ci
飯傘	饭伞	飯傘	vae sae
飯糝	饭糁	飯糝	vae sei
飯米糝	饭米糁	飯米糝	vae mi sei
飯窠	饭窠	飯窠	vae khou
飯僵脯𡀂	饭僵脯𡀂	飯僵脯𡀂	vae cian bu lei
飯碗	饭碗	飯碗	vae un
飯碗頭	饭碗头	飯碗頭	vae un deu
飯蒸	饭蒸	飯蒸	vae cin
飯桶	饭桶	飯桶	vae don
飯格	饭格	飯格	vae kaq
飯格子	饭格子	飯格子	vae kaq tsy
飯鑊	饭镬	飯鑊	vae ghoq
飯鑊頭蒼蠅	饭镬头苍蝇	飯鑊頭蒼蠅	vae ghoq deu tshaon in
飯鑊飲湯	饭镬饮汤	飯鑊飲湯	vae ghoq in thaon
萬試萬應	万试万应	萬試萬應	vae sy vae in
萬年青	万年青	萬年青	vae gni chin
萬寶全書	万宝全书	萬寶全書	vae pau dzoe syu
萬花筒	万花筒	萬花筒	vae huo don
萬三	万三	萬三	vae sae
萬三鬼	万三鬼	萬三鬼	vae sae ciu
萬生萬世	万生万世	萬生萬世	vae san vae shi
範	范	範	vae4
單邊	单边	單邊	tae pi
單褲	单裤	單褲	tae khu
單票	单票	單票	tae phiau
單超	单超	單超	tae chiau
單要	单要	單要	tae iau
單隑人	单隑人	單隑人	tae ge gnin
單單	单单	單單	tae tae
單衫	单衫	單衫	tae sae
單眼沿	单眼沿	單眼沿	tae ngae yi
單眼竈	单眼灶	單眼竈	tae ngae tsau
單頭重	单头重	單頭重	tae deu dzon
單方	单方	單方	tae faon
單薄	单薄	單薄	tae boq
單角落頭	单角落头	單角落頭	tae koq loq deu
單耳朵	单耳朵	單耳朵	tae ng to
單耳朵	单耳朵	單耳朵	tae gni to
撣	掸	撣	tae3
撣田墈	掸田墈	撣田墈	tae di khe
撣塵	掸尘	撣塵	tae jin
膽	胆	膽	tae3
擔	担	擔	tae5
擔飯	担饭	擔飯	tae vae
擔鈎	担钩	擔鉤	tae keu
坍臺	坍台	坍臺	thae de
舑	舑	舑	thae1
舑	舑	舑	tha1
勯	勯	勯	thae1
攤	摊	攤	thae1
攤屍	摊尸	攤屍	thae sy
攤屍牀	摊尸床	攤屍牀	thae sy zaon
攤販	摊贩	攤販	thae fae
攤頭	摊头	攤頭	thae deu
攤餅	摊饼	攤餅	thae pin
灘簧	滩簧	灘簧	thae waon
坦	坦	坦	thae3
坦盆	坦盆	坦盆	thae ben
毯子	毯子	毯子	thae tsy
炭	炭	炭	thae5
炭墼	炭墼	炭墼	thae ciq
嘆苦經	叹苦经	嘆苦經	thae khu cin
痰瓶	痰瓶	痰瓶	dae bin
痰盂	痰盂	痰盂	dae yu
痰盂罐	痰盂罐	痰盂罐	dae yu kun
彈	弹	彈	dae2
彈子	弹子	彈子	dae tsy
彈子棋	弹子棋	彈子棋	dae tsy ji
彈○嘴	弹○嘴	彈○嘴	dae tsyu
彈塗魚	弹涂鱼	彈塗魚	dae du yu
彈花	弹花	彈花	dae huo
彈花㪝槌	弹花㪝槌	彈花㪝槌	dae huo li dzyu
彈眼睩睛	弹眼睩睛	彈眼睩睛	dae ngae loq cin
彈硬	弹硬	彈硬	dae ngan
彈簧	弹簧	彈簧	dae waon
彈簧眠牀	弹簧眠床	彈簧眠牀	dae waon mi zaon
彈簧秤	弹簧秤	彈簧秤	dae waon chin
彈門蟹	弹门蟹	彈門蟹	dae men ha
談山海經	谈山海经	談山海經	dae sae he cin
談朋友	谈朋友	談朋友	dae ban yeu
壇	坛	壇	dae2
燂茶	燂茶	燂茶	dae dzo
檀香扇	檀香扇	檀香扇	dae shian shi
檀香橄欖	檀香橄榄	檀香橄欖	dae shian kae lae
但便	但便	但便	dae bi
淡	淡	淡	dae4
淡水毛帳	淡水毛帐	淡水毛帳	dae syu mau cian
淡水刮得	淡水刮得	淡水刮得	dae syu kuaq taq
淡包	淡包	淡包	dae pau
淡包車	淡包车	淡包車	dae pau tsho
汽車	汽车	汽車	chi tsho
淡沙沙	淡沙沙	淡沙沙	dae so so
淡水水	淡水水	淡水水	dae syu syu
淡菜	淡菜	淡菜	dae tshe
淡呵呵	淡呵呵	淡呵呵	dae hou hou
淡口	淡口	淡口	dae kheu
淡刮刮	淡刮刮	淡刮刮	dae kuaq kuaq
淡結刮勒	淡结刮勒	淡結刮勒	dae ciq kuaq laq
淡竹	淡竹	淡竹	dae tsoq
蛋炒飯	蛋炒饭	蛋炒飯	dae tshau vae
蛋糕	蛋糕	蛋糕	dae kau
蛋花湯	蛋花汤	蛋花湯	dae huo thaon
蛋湯	蛋汤	蛋湯	dae thaon
蛋黄	蛋黄	蛋黃	dae uaon
蛋白	蛋白	蛋白	dae baq
蛋殻球	蛋壳球	蛋殼球	dae khoq jieu
氮肥	氮肥	氮肥	dae vi
難看	难看	難看	nae khI
難相	难相	難相	nae shian
難看掉	难看掉	難看掉	nae khI diau
難熬	难熬	難熬	nae ngau
難話	难话	難話	nae wo
難講	难讲	難講	nae kaon
難爲	难为	難爲	nae wei
難爲情	难为情	難爲情	nae wei jin
難過	难过	難過	nae kou
難弄	难弄	難弄	nae lon
乃遭	乃遭	乃遭	nae tsau
乃則	乃则	乃則	nae tsaq
乃末	乃末	乃末	nae maq
乃	乃	乃	nae4
乃間○	乃间○	乃間○	nae kae
爛泥	烂泥	爛泥	nae gni
爛泥塊	烂泥块	爛泥塊	nae gni khuei
爛污泥	烂污泥	爛污泥	nae u gni
爛污泥	烂污泥	爛污泥	lae u gni
藍	蓝	藍	lae2
藍邊碗	蓝边碗	藍邊碗	lae pi un
藍○扮○	蓝○扮○	藍○扮○	lae pae
藍○扮○頭	蓝○扮○头	藍○扮○頭	lae pae deu
藍印紙	蓝印纸	藍印紙	lae in tsy
藍接接	蓝接接	藍接接	lae ciq ciq
籃	篮	籃	lae2
籃球	篮球	籃球	lae jieu
籃球鞋	篮球鞋	籃球鞋	lae jieu gha
蘭花	兰花	蘭花	lae huo
蘭花手	兰花手	蘭花手	lae huo shieu
蘭花指末頭	兰花指末头	蘭花指末頭	lae huo tsy maq deu
蘭花豆	兰花豆	蘭花豆	lae huo deu
蘭花倭豆	兰花倭豆	蘭花倭豆	lae huo ou deu
懶懈懈	懒懈懈	懶懈懈	lae ga ga
懶塌塌	懒塌塌	懶塌塌	lae thaq thaq
懶呵呵	懒呵呵	懶呵呵	lae hou hou
懶拖拖	懒拖拖	懶拖拖	lae thou thou
懶嘆氣	懒叹气	懶嘆氣	lae thae chi
懶撲	懒扑	懶撲	lae phoq
懶惰坯	懒惰坯	懶惰坯	lae dou phei
爛田	烂田	爛田	lae di
爛腐	烂腐	爛腐	lae vu
爛腐貨	烂腐货	爛腐貨	lae vu hou
爛○唾水	烂○唾水	爛○唾水	lae thu syu
爛○唾水	烂○唾水	爛○唾水	lae do syu
爛稻索	烂稻索	爛稻索	lae dau soq
爛好人	烂好人	爛好人	lae hau gnin
爛飯	烂饭	爛飯	lae vae
爛眼沿	烂眼沿	爛眼沿	lae ngae yi
爛屙	烂屙	爛屙	lae ou
爛賬	烂账	爛賬	lae cian
爛蟲	烂虫	爛蟲	lae dzon
爛薄屙	烂薄屙	爛薄屙	lae boq ou
爛薄屙	烂薄屙	爛薄屙	lae baq ou
爛薄稀屙	烂薄稀屙	爛薄稀屙	lae boq shi ou
爛薄稀屙	烂薄稀屙	爛薄稀屙	lae baq shi ou
爛雪片	烂雪片	爛雪片	lae syuq phi
爛䏘	烂䏘	爛䏘	lae phiq
斬	斩	斬	tsae1
斬旗	斩旗	斬旗	tsae ji
斬齊	斩齐	斬齊	tsae zhi
邅	邅	邅	tsae1
盞	盏	盞	tsae3
斬肉	斩肉	斬肉	tsae gnioq
撍	撍	撍	tsae5
蘸	蘸	蘸	tsae5
灒	𪷽	灒	tsae5
㜺	㜺	㜺	tsae5
摻	掺	摻	tshae1
攙	搀	攙	tshae1
鏟㽘	铲㽘	鏟㽘	tshae gaon
剗	刬	剗	tshae5
剗穿	刬穿	剗穿	tshae tshOE
剗只	刬只	剗只	tshae ciq
𪙞牙	𪙞牙	𪙞牙	tshae ngo
殘疾	残疾	殘疾	dzae jiq
饞癆	馋痨	饞癆	dzae lau
饞癆槽	馋痨槽	饞癆槽	dzae lau zau
饞癆窞	馋痨窞	饞癆窞	dzae lau dei
饞癆丫碼○	馋痨丫码○	饞癆丫碼○	dzae lau o mo
饞癆蟲	馋痨虫	饞癆蟲	dzae lau dzon
站頭	站头	站頭	dzae deu
棧房	栈房	棧房	dzae vaon
𡓦頭	𡓦头	𡓦頭	dzae deu
綻	绽	綻	dzae6
綻○	绽○	綻○	dzae6
綻柱	绽柱	綻柱	dzae dzyu
赚	赚	賺	dzae6
赚外快	赚外快	賺外快	dzae nga khua
賺頭	赚头	賺頭	dzae deu
賺進	赚进	賺進	dzae cin
賺銅鈿	赚铜钿	賺銅鈿	dzae don di
賺鈔票	赚钞票	賺鈔票	dzae tshau phiau
蹔𧉆	𫏐𧉆	蹔𧉆	dzae ciq
三	三	三	sae1
三時八節	三时八节	三時八節	sae zy paq ciq
三八兩時	三八两时	三八兩時	sae paq lian zy
三八時	三八时	三八時	sae paq zy
三點水	三点水	三點水	sae ti syu
三千	三千	三千	sae chi
三鮮湯	三鲜汤	三鮮湯	sae shi thaon
三言兩語	三言两语	三言兩語	sae yi lian gniu
三勸兩勸	三劝两劝	三勸兩勸	sae chiu lian chiu
三埭頭	三埭头	三埭頭	sae da deu
三卡	三卡	三卡	sae kha
三夜桶	三夜桶	三夜桶	sae ya don
三號	三号	三號	sae ghau
三家軋出做頭家	三家轧出做头家	三家軋出做頭家	sae ko gaq tshyuq tsou deu ko
三朝	三朝	三朝	sae jiau
三番兩次	三番两次	三番兩次	sae fae lian tshy
三翻四覆	三翻四覆	三翻四覆	sae fae sy foq
三萬五千	三万五千	三萬五千	sae vae ng chi
三萬一	三万一	三萬一	sae vae iq
三萬二	三万二	三萬二	sae vae gni
三萬兩	三万两	三萬兩	sae vae lian
三萬三	三万三	三萬三	sae vae sae
三萬四	三万四	三萬四	sae vae sy
三萬六	三万六	三萬六	sae vae loq
三萬七	三万七	三萬七	sae vae chiq
三萬八	三万八	三萬八	sae vae paq
三萬九	三万九	三萬九	sae vae cieu
三三兩兩	三三两两	三三兩兩	sae sae lian lian
三眼竈	三眼灶	三眼竈	sae ngae tsau
三彎涼牀	三弯凉床	三彎涼牀	sae uae lian zaon
三頭六面	三头六面	三頭六面	sae deu loq mi
三腳六面	三脚六面	三腳六面	sae ciaq loq mi
三長兩短	三长两短	三長兩短	sae jian lian toe
三官暴	三官暴	三官暴	sae kun pau
三輪車	三轮车	三輪車	sae len tsho
三輪車夫	三轮车夫	三輪車伕	sae len tsho fu
三輪車人	三轮车人	三輪車人	sae len tsho gnin
三心兩意	三心两意	三心兩意	sae shin lian i
三弄四弄	三弄四弄	三弄四弄	sae lon sy lon
三話四話	三话四话	三話四話	sae wo sy wo
三兄四弟	三兄四弟	三兄四弟	sae shion sy di
三百十	三百十	三百十	sae paq zyuq
三百一	三百一	三百一	sae paq iq
三百二	三百二	三百二	sae paq gni
三百兩	三百两	三百兩	sae paq lian
三百三	三百三	三百三	sae paq sae
三百四	三百四	三百四	sae paq sy
三百五	三百五	三百五	sae paq ng
三百六	三百六	三百六	sae paq loq
三百七	三百七	三百七	sae paq chiq
三百八	三百八	三百八	sae paq paq
三百九	三百九	三百九	sae paq cieu
三搭六橋	三搭六桥	三搭六橋	sae taq loq jiau
三隻手	三只手	三隻手	sae tsaq shieu
三色	三色	三色	sae saq
三嚇頭	三吓头	三嚇頭	sae haq deu
三腳架	三脚架	三腳架	sae ciaq ko
三腳	三脚	三腳	sae ciaq
三腳貓	三脚猫	三腳貓	sae ciaq mae
三伏	三伏	三伏	sae voq
三角褲	三角裤	三角褲	sae koq khu
三角包	三角包	三角包	sae koq pau
三角眼	三角眼	三角眼	sae koq ngae
三角尺	三角尺	三角尺	sae koq tshaq
三日三夜	三日三夜	三日三夜	sae gniq sae ya
三日兩頭	三日两头	三日兩頭	sae gniq lian deu
三一	三一	三一	sae iq
三十一	三十一	三十一	sae zyuq iq
三二	三二	三二	sae gni
三兩	三两	三兩	sae lian
三三	三三	三三	sae sae
三四	三四	三四	sae sy
三五	三五	三五	sae ng
三六	三六	三六	sae loq
三七	三七	三七	sae chiq
三八	三八	三八	sae paq
三九	三九	三九	sae cieu
三十	三十	三十	sae zyuq
三十年夜	三十年夜	三十年夜	sae zyuq gni ya
三十年夜	三十年夜	三十年夜	sae syuq gni ya
山	山	山	sae1
山裏	山里	山裏	sae li
山高頭	山高头	山高頭	sae kau deu
山前頭	山前头	山前頭	sae zhi deu
山艿	山艿	山艿	sae na
山嶴	山岙	山嶴	sae au
山楂片	山楂片	山楂片	sae dzo phi
山坡	山坡	山坡	sae phou
山頭登	山头登	山頭登	sae deu ten
山溝	山沟	山溝	sae keu
山後頭	山后头	山後頭	sae gheu deu
山羊	山羊	山羊	sae yan
山羊牙鬚	山羊牙须	山羊牙鬚	sae yan ngo su
山粉	山粉	山粉	sae fen
山腳下	山脚下	山腳下	sae ciaq gho
杉樹	杉树	杉樹	sae zyu
杉木	杉木	杉木	sae moq
舢板	舢板	舢板	sae pae
傘	伞	傘	sae1
散滔滔	散滔滔	散滔滔	sae thau thau
散板	散板	散板	sae pae
散場	散场	散場	sae jian
散腳	散脚	散腳	sae ciaq
赛可	赛可	賽可	se khou
嚵	嚵	嚵	zae2
饞唾	馋唾	饞唾	zae thu
饞唾水	馋唾水	饞唾水	zae thu syu
饞唾水	馋唾水	饞唾水	zae do syu
饞脱	馋脱	饞脫	zae thaq
僝	僝	僝	zae4
劖	劖	劖	zae4
劖白	劖白	劖白	zae baq
奸	奸	奸	kae1
奸刁	奸刁	奸刁	kae tiau
監牢	监牢	監牢	kae lau
監工	监工	監工	kae kon
間	间	間	kae3
間架	间架	間架	kae ko
間日	间日	間日	kae gniq
間日班	间日班	間日班	kae gniq pae
揀	拣	揀	kae3
揀棉花	拣棉花	揀棉花	kae mi huo
揀菜	拣菜	揀菜	kae tshe
揀落漿	拣落浆	揀落漿	kae loq cian
減	减	減	kae3
減年成	减年成	減年成	kae gni jin
減壽	减寿	減壽	kae zhieu
減壽命	减寿命	減壽命	kae zhieu min
橄欖	橄榄	橄欖	kae lae
襇	裥	襉	kae3
襇○	裥○	襉○	kae3
諫訓	谏训	諫訓	kae shiun
尷○	尴○	尷○	kae5
尷○屁眼	尴○屁眼	尷○屁眼	kae phi ngae
尷○屙屁眼	尴○屙屁眼	尷○屙屁眼	kae ou phi ngae
尷裏尷尬	尴里尴尬	尷裏尷尬	kae li kae ka
尷裏勿尷尬	尴里勿尴尬	尷裏勿尷尬	kae li vaq kae ka
鉛皮	铅皮	鉛皮	khae bi
鉛皮匠	铅皮匠	鉛皮匠	khae bi zhian
鉛桶	铅桶	鉛桶	khae don
鉛筆	铅笔	鉛筆	khae piq
嵌寶戒	嵌宝戒	嵌寶戒	khae pau ka
檻窗	槛窗	檻窗	khae tshaon
諫	谏	諫	gae6
諫嘴諫得	谏嘴谏得	諫嘴諫得	gae tsyu gae taq
諫腐一樣	谏腐一样	諫腐一樣	gae vu iq yan
顏蠟筆	颜蜡笔	顏蠟筆	ngae laq piq
顔色	颜色	顏色	ngae saq
眼子	眼子	眼子	ngae tsy
眼眉毛	眼眉毛	眼眉毛	ngae mi mau
眼面前	眼面前	眼面前	ngae mi zhi
眼淚水	眼泪水	眼淚水	ngae li syu
眼淚	眼泪	眼淚	ngae li
眼淚出	眼泪出	眼淚出	ngae li tshyuq
眼烏珠	眼乌珠	眼烏珠	ngae u tsyu
眼烏珠䀨瞎	眼乌珠䀨瞎	眼烏珠䀨瞎	ngae u tsyu kuaq haq
眼圈	眼圈	眼圈	ngae chiu
眼虚突腫	眼虚突肿	眼虛突腫	ngae shiu daq tson
眼泡皮	眼泡皮	眼泡皮	ngae phau bi
眼花祺	眼花祺	眼花祺	ngae huo ji
眼開眼閉	眼开眼闭	眼開眼閉	ngae khe ngae pi
眼眼叫	眼眼叫	眼眼叫	ngae ngae ciau
眼窞	眼窞	眼窞	ngae dei
眼火	眼火	眼火	ngae hou
眼屙	眼屙	眼屙	ngae ou
眼頭	眼头	眼頭	ngae deu
眼癢	眼痒	眼癢	ngae yan
眼睛癢	眼睛痒	眼睛癢	ngae cin yan
眼窗骨	眼窗骨	眼窗骨	ngae tshaon kuaq
眼眶	眼眶	眼眶	ngae khuaon
眼睛	眼睛	眼睛	ngae cin
眼睛閉攏	眼睛闭拢	眼睛閉攏	ngae cin pi lon
眼睛白白	眼睛白白	眼睛白白	ngae cin baq baq
眼睛眨眨	眼睛眨眨	眼睛眨眨	ngae cin saq saq
眼睛一眨	眼睛一眨	眼睛一眨	ngae cin iq saq
眼鏡店	眼镜店	眼鏡店	ngae cin ti
眼孔淺	眼孔浅	眼孔淺	ngae khon chi
眼白	眼白	眼白	ngae baq
眼眨毛	眼眨毛	眼眨毛	ngae saq mau
眼角落頭	眼角落头	眼角落頭	ngae koq loq deu
莧菜	苋菜	莧菜	hae tshe
莧菜管	苋菜管	莧菜管	hae tshe kun
閑時不節	闲时不节	閒時不節	ghae zy paq ciq
閑早	闲早	閒早	ghae tsau
閑早子	闲早子	閒早子	ghae tsau tsy
閑話	闲话	閒話	ghae wo
閑兩遭	闲两遭	閒兩遭	ghae lian tsau
閑白○直○	闲白○直○	閒白○直○	ghae baq jiq
閑日	闲日	閒日	ghae gniq
閑食	闲食	閒食	ghae zhiq
鹹	咸	鹹	ghae2
鹹滋滋	咸滋滋	鹹滋滋	ghae tsy tsy
鹹咪咪	咸咪咪	鹹咪咪	ghae mhi mhi
鹹地	咸地	鹹地	ghae di
鹹𧆌	咸𧆌	鹹𧆌	ghae ci
鹹𧆌菜	咸𧆌菜	鹹𧆌菜	ghae ci tshe
鹹菜	咸菜	鹹菜	ghae tshe
鹹𧆌大湯黄魚	咸𧆌大汤黄鱼	鹹𧆌大湯黃魚	ghae ci dou thaon waon ng
鹹苦	咸苦	鹹苦	ghae khu
鹹蟹	咸蟹	鹹蟹	ghae ha
鹹草	咸草	鹹草	ghae tshau
鹹菜色	咸菜色	鹹菜色	ghae tshe saq
鹹蛋	咸蛋	鹹蛋	ghae dae
鹹貨店	咸货店	鹹貨店	ghae hou ti
鹹口	咸口	鹹口	ghae kheu
鹹	咸	鹹	ghae2
鹹光餅	咸光饼	鹹光餅	ghae kuaon pin
鹹餅乾	咸饼干	鹹餅乾	ghae pin kI
鹹辣辣	咸辣辣	鹹辣辣	ghae laq laq
鹹𣝗青果	咸𣝗青果	鹹𣝗青果	ghae waq chin kou
鹹𣝗	咸𣝗	鹹𣝗	ghae waq
鹹肉	咸肉	鹹肉	ghae gnioq
限卯	限卯	限卯	ghae mau
限板	限板	限板	ghae pae
陷	陷	陷	ghae6
餡子	馅子	餡子	ghae tsy
鴨	鸭	鴨	ae3
鴨	鸭	鴨	aq7
晏	晏	晏	ae5
晏眼	晏眼	晏眼	ae ngae
晏發人	晏发人	晏發人	ae faq gnin
關店	关店	關店	kuae ti
關帝菩薩	关帝菩萨	關帝菩薩	kuae ti bu saq
關夜學	关夜学	關夜學	kuae ya ghoq
關照	关照	關照	kuae ciau
關胎	关胎	關胎	kuae the
關晝學	关昼学	關晝學	kuae cieu ghoq
關門	关门	關門	kuae men
慣常	惯常	慣常	kuae dzaon
筷	筷	筷	khuae5
筷箸籠	筷箸笼	筷箸籠	khuae ji lon
環	环	環	guae2
環子	环子	環子	guae tsy
環頭	环头	環頭	guae deu
環頭	环头	環頭	guaq deu
環頭環腦	环头环脑	環頭環腦	guae deu guae nau
環洞橋	环洞桥	環洞橋	guae don jiau
掼	掼	摜	guae6
掼炮	掼炮	摜炮	guae phau
掼稻	掼稻	摜稻	guae dau
掼鑼槌	掼锣槌	摜鑼槌	guae lou dzyu
儇	儇	儇	huae1
儇儇個	儇儇个	儇儇個	huae huae kou
甩	甩	甩	huae5
甩	甩	甩	huaq7
甩頭	甩头	甩頭	huae deu
還	还	還	wae2
還願心	还愿心	還願心	wae gniu shin
還報門	还报门	還報門	wae pau men
還價	还价	還價	wae ko
還潮	还潮	還潮	wae jiau
還魂酒	还魂酒	還魂酒	wae wen cieu
還俗	还俗	還俗	wae dzoq
環	环	環	wae6
環嘴	环嘴	環嘴	wae tsyu
環肩胛	环肩胛	環肩胛	wae ci kaq
環襻頭	环襻头	環襻頭	wae phae deu
環眼	环眼	環眼	wae ngae
環落	环落	環落	wae loq
彎	弯	彎	uae1
彎角	弯角	彎角	uae koq
彎折格亂	弯折格乱	彎折格亂	uae ciq kaq loe
挽	挽	挽	uae3
頑	顽	頑	uae3
帵子	帵子	帵子	uae tsy
留級	留级	留級	lieu ciq
流火	流火	流火	lieu hou
流黄	流黄	流黃	lieu uaon
流星	流星	流星	lieu shin
柳○	柳○	柳○	lieu6
柳樹	柳树	柳樹	lieu zyu
柳條	柳条	柳條	lieu diau
柳隆慶	柳隆庆	柳隆慶	lieu lon chin
溜	溜	溜	lieu6
磚牑	砖牑	磚牑	tsoe bi
磚坯	砖坯	磚坯	tsoe phei
磚頭	砖头	磚頭	tsoe deu
磚方	砖方	磚方	tsoe faon
磚角方	砖角方	磚角方	tsoe koq faon
磚方的角	砖方的角	磚方的角	tsoe faon tiq koq
轉	转	轉	tsoe3
轉椅	转椅	轉椅	tsoe i
轉椅	转椅	轉椅	tsoe iu
轉來	转来	轉來	tsoe le
轉色	转色	轉色	tsoe saq
鑽子	钻子	鑽子	tsoe tsy
鑽戒	钻戒	鑽戒	tsoe ka
鑽漿	钻浆	鑽漿	tsoe cian
鑽倉老鼠	钻仓老鼠	鑽倉老鼠	tsoe tshaon lau tsy
穿連襠褲	穿连裆裤	穿連襠褲	tshOE li taon khu
穿綫綳	穿线绷	穿線繃	tshOE shi pan
穿綳	穿绷	穿繃	tshOE pan
穿堂	穿堂	穿堂	tshOE daon
穿針屁眼	穿针屁眼	穿針屁眼	tshOE cin phi ngae
穿針	穿针	穿針	tshOE cin
穿心旁	穿心旁	穿心旁	tshOE shin baon
穿棕綳個	穿棕绷个	穿棕繃個	tshOE tson pan goq
穿空殼棉襖	穿空壳棉袄	穿空殼棉襖	tshOE khon khoq mi au
穿着	穿着	穿着	tshOE ciaq
竄頭	窜头	竄頭	tshoe deu
攛	撺	攛	tshoe1
攛風調	撺风调	攛風調	tshoe fon diau
躥	蹿	躥	tshoe5
串	串	串	tshoe5
全夜	全夜	全夜	dzoe ya
泉水	泉水	泉水	dzOE syu
椽子	椽子	椽子	dzOE tsy
諓	諓	諓	dzoe2
宣紙	宣纸	宣紙	soe tsy
酸	酸	酸	soe1
酸滋滋	酸滋滋	酸滋滋	soe tsy tsy
酸丟丟	酸丢丢	酸丟丟	soe tieu tieu
酸梅湯	酸梅汤	酸梅湯	soe mei thaon
酸口	酸口	酸口	soe kheu
酸漿氣	酸浆气	酸漿氣	soe cian chi
酸汪汪	酸汪汪	酸汪汪	soe uaon uaon
酸汪氣	酸汪气	酸汪氣	soe uaon chi
蒜泥	蒜泥	蒜泥	soe gni
蒜苗	蒜苗	蒜苗	soe miau
算數	算数	算數	soe su
算賬	算账	算賬	soe cian
算盤	算盘	算盤	soe bun
算盤子	算盘子	算盤子	soe bun tsy
算命	算命	算命	soe min
算命先生	算命先生	算命先生	soe min shi san
算命瞎眼	算命瞎眼	算命瞎眼	soe min haq ngae
船	船	船	zOE2
船機	船机	船機	zOE ci
船大身	船大身	船大身	zOE da shin
船鞋	船鞋	船鞋	zOE gha
船老大	船老大	船老大	zOE lau da
船頭	船头	船頭	zOE deu
船洋	船洋	船洋	zOE yan
船尾巴	船尾巴	船尾巴	zOE ng po
船尾巴	船尾巴	船尾巴	zOE mi po
旋	旋	旋	zoe2
鱔魚	鳝鱼	鱔魚	zoe ng
鱔魚羹	鳝鱼羹	鱔魚羹	zoe ng kan
糾會	纠会	糾會	cieu wei
糾○作	纠○作	糾○作	cieu tsoq
周年	周年	週年	cieu gni
九	九	九	cieu3
九號	九号	九號	cieu ghau
九頭蘭	九头兰	九頭蘭	cieu deu lae
九一	九一	九一	cieu iq
九十一	九十一	九十一	cieu zyuq iq
九二	九二	九二	cieu gni
九兩	九两	九兩	cieu lian
九三	九三	九三	cieu sae
九四	九四	九四	cieu sy
九五	九五	九五	cieu ng
九六	九六	九六	cieu loq
九七	九七	九七	cieu chiq
九八	九八	九八	cieu paq
九九	九九	九九	cieu cieu
九十	九十	九十	cieu zyuq
韭菜	韭菜	韭菜	cieu tshe
韭菜芽	韭菜芽	韭菜芽	cieu tshe ngo
韭芽	韭芽	韭芽	cieu ngo
酒水	酒水	酒水	cieu syu
酒店	酒店	酒店	cieu ti
酒家	酒家	酒家	cieu ko
酒提	酒提	酒提	cieu di
酒壺	酒壶	酒壺	cieu wu
酒槽鼻	酒槽鼻	酒槽鼻	cieu zau biq
酒杯	酒杯	酒杯	cieu pei
酒釀	酒酿	酒釀	cieu gnian
酒坊	酒坊	酒坊	cieu faon
酒埕	酒埕	酒埕	cieu jin
酒盅	酒盅	酒盅	cieu tson
酒腳	酒脚	酒腳	cieu ciaq
酒腳	酒脚	酒腳	cieu cian
酒肉朋友	酒肉朋友	酒肉朋友	cieu gnioq ban yeu
救火車	救火车	救火車	cieu hou tsho
救生船	救生船	救生船	cieu sen zOE
救命車	救命车	救命車	cieu min tsho
救護車	救护车	救護車	cieu wu tsho
晝飯	昼饭	晝飯	cieu vae
晝過飯	昼过饭	晝過飯	cieu kou vae
晝過	昼过	晝過	cieu kou
晝過頭	昼过头	晝過頭	cieu kou deu
丘	丘	丘	chieu1
抽	抽	抽	chieu1
抽股結	抽股结	抽股結	chieu ku ciq
抽油	抽油	抽油	chieu yeu
抽斗	抽斗	抽斗	chieu teu
抽頭	抽头	抽頭	chieu deu
抽筋	抽筋	抽筋	chieu cin
抽腳筋	抽脚筋	抽腳筋	chieu ciaq cin
秋天價	秋天价	秋天價	chieu thi ko
秋埭○	秋埭○	秋埭○	chieu da
秋收	秋收	秋收	chieu shieu
秋場裏	秋场里	秋場裏	chieu jian li
秋分	秋分	秋分	chieu fen
秋厄○伏○	秋厄○伏○	秋厄○伏○	chieu aq boq
揫	揫	揫	chieu1
𥻤	𥻤	𥻤	chieu1
丑	丑	醜	chieu3
臭	臭	臭	chieu5
臭稀稀	臭稀稀	臭稀稀	chieu shi shi
臭鹵	臭卤	臭滷	chieu lu
臭花娘子	臭花娘子	臭花娘子	shieu huo gnian tsy
臭灰蛋	臭灰蛋	臭灰蛋	chieu huei dae
臭豆腐	臭豆腐	臭豆腐	chieu deu vu
臭醬豆腐	臭酱豆腐	臭醬豆腐	chieu cian deu vu
臭冬瓜	臭冬瓜	臭冬瓜	chieu ton kuo
臭齆齆	臭齆齆	臭齆齆	chieu nhon nhon
臭蟲	臭虫	臭蟲	chieu dzon
臭烘烘	臭烘烘	臭烘烘	chieu hon hon
臭墨	臭墨	臭墨	chieu moq
求簽	求签	求籤	jieu chi
求簽詩	求签诗	求籤詩	jieu chi sy
求靠	求靠	求靠	jieu khau
㨨	㨨	㨨	jieu2
稠𣿊	稠𣿊	稠𣿊	jieu li
綢布店	绸布店	綢布店	jieu pu ti
桕子樹	桕子树	桕子樹	jieu tsy zyu
舅老	舅老	舅老	jieu lau
舅老爺	舅老爷	舅老爺	jieu lau ya
舅舅	舅舅	舅舅	jieu jieu
舅姆	舅姆	舅姆	jieu m
舊年子	旧年子	舊年子	jieu gni tsy
舊那那	旧那那	舊那那	jieu nha nha
扭	扭	扭	knieu1
扭痧氣	扭痧气	扭痧氣	knieu so chi
原舊	原旧	原舊	gnieu jieu
原方	原方	原方	gnieu faon
扭	扭	扭	gnieu4
扭轉	扭转	扭轉	gnieu tsoe
扭紐子	扭纽子	扭紐子	gnieu gnieu tsy
扭秧歌	扭秧歌	扭秧歌	gnieu ian kou
紐子	纽子	紐子	gnieu tsy
紐子紐梅○	纽子纽梅○	紐子紐梅○	gnieu tsy gnieu mei
紐子洞眼	纽子洞眼	紐子洞眼	gnieu tsy don ngae
紐襻	纽襻	紐襻	gnieu phae
收據	收据	收據	shieu ciu
收曬㫰	收晒㫰	收曬㫰	shieu sa laon
收稻	收稻	收稻	shieu dau
收罪過	收罪过	收罪過	shieu zei kou
收賬	收账	收賬	shieu cian
收成	收成	收成	shieu jin
收工	收工	收工	shieu kon
收作	收作	收作	shieu tsoq
休閑	休闲	休閒	shieu ghae
修面	修面	修面	shieu mi
修道長老	修道长老	修道長老	shieu dau cian lau
修行個	修行个	修行個	shieu ghan goq
手	手	手	shieu3
手指末頭	手指末头	手指末頭	shieu tsy maq deu
手指末頭縫蕩	手指末头缝荡	手指末頭縫蕩	shieu tsy maq deu von daon
手指掐	手指掐	手指掐	shieu tsy khaq
手勢	手势	手勢	shieu syu
手天爿	手天爿	手天爿	shieu thi bae
手天心	手天心	手天心	shieu thi shin
手提琴	手提琴	手提琴	shieu di jin
手鏈	手链	手鍊	shieu li
手氣	手气	手氣	shieu chi
手藝人	手艺人	手藝人	shieu gni gnin
手爐	手炉	手爐	shieu lu
手拉車	手拉车	手拉車	shieu lha tsho
手套	手套	手套	shieu thau
手銬	手铐	手銬	shieu khau
手把子	手把子	手把子	shieu po tsy
手叉仔	手叉仔	手叉仔	shieu tsho tsy
手錶	手表	手錶	shieu piau
手板面	手板面	手板面	shieu pae mi
手反背絞仔	手反背绞仔	手反背絞仔	shieu fae pei gau tsy
手關手閉	手关手闭	手關手閉	shieu kuae shieu pi
手㬹子頭	手㬹子头	手㬹子頭	shieu tsan tsy deu
手膀	手膀	手膀	shieu phaon
手巾	手巾	手巾	shieu cin
手勁	手劲	手勁	shieu jin
手腳	手脚	手腳	shieu ciaq
手骨	手骨	手骨	shieu kuaq
手骨𢺴出	手骨𢺴出	手骨𢺴出	shieu kuaq iuq tshyuq
手膊絡○頭	手膊络○头	手膊絡○頭	shieu boq loq deu
手盤○路○頭	手盘○路○头	手盤○路○頭	shieu bun lu deu
手越○越○	手越○越○	手越○越○	shi yuq yuq
守孝	守孝	守孝	shieu hau
守靈	守灵	守靈	shieu lin
首飾	首饰	首飾	shieu shiq
繡花綳	绣花绷	繡花繃	shieu huo pan
受委氣	受委气	受委氣	zhieu uei chi
袖子管	袖子管	袖子管	zhieu tsy kun
袖套龍	袖套龙	袖套龍	zhieu thau lon
袖套	袖套	袖套	zhieu thau
袖頭子	袖头子	袖頭子	zhieu deu tsy
壽○	寿○	壽○	zhieu6
壽○得得	寿○得得	壽○得得	zhieu taq taq
壽○刮刮	寿○刮刮	壽○刮刮	zhieu kuaq kuaq
壽○頭刮氣	寿○头刮气	壽○頭刮氣	zhieu deu kuaq chi
壽○頭刮得	寿○头刮得	壽○頭刮得	zhieu deu kuaq taq
壽衣	寿衣	壽衣	zhieu i
壽桃	寿桃	壽桃	zhieu dau
壽糕	寿糕	壽糕	zhieu kau
壽材	寿材	壽材	zhieu ze
壽斑	寿斑	壽斑	zhieu pae
壽○頭	寿○头	壽○頭	zhieu deu
壽○頭碼子	寿○头码子	壽○頭碼子	zhieu deu mo tsy
壽○頭壽腦	寿○头寿脑	壽○頭壽腦	zhieu deu zhieu nau
壽○頭刮腦	寿○头刮脑	壽○頭刮腦	zhieu deu kuaq nau
壽星	寿星	壽星	zhieu shin
壽星竹	寿星竹	壽星竹	zhieu shin tsoq
壽燭	寿烛	壽燭	zhieu tsoq
酉	酉	酉	yeu2
油	油	油	yeu2
油水	油水	油水	yeu syu
油皮	油皮	油皮	yeu bi
油皮糙起	油皮糙起	油皮糙起	yeu bi tshau chi
油咪咪	油咪咪	油咪咪	yeu mhi mhi
油麵筋	油面筋	油麪筋	yeu mi cin
油煎餛飩	油煎馄饨	油煎餛飩	yeu ci wen den
油布傘	油布伞	油布傘	yeu pu sae
油爆蝦	油爆虾	油爆蝦	yeu pau huo
油蒿蒿	油蒿蒿	油蒿蒿	yeu hau hau
油蒿氣	油蒿气	油蒿氣	yeu hau chi
油挪挪	油挪挪	油挪挪	yeu no no
油麥麥	油麦麦	油麥麥	yeu maq maq
油注刮得	油注刮得	油注刮得	yeu tsyu kuaq taq
油漬格勒	油渍格勒	油漬格勒	yeu ciq kaq laq
油車	油车	油車	yeu tsho
油彫	油雕	油雕	yeu tiau
油彫甏	油雕甏	油雕甏	yeu tiau ban
油菜	油菜	油菜	yeu tshe
油饡子	油饡子	油饡子	yeu tsae tsy
油果	油果	油果	yeu kou
油棗	油枣	油棗	yeu tsau
油豆腐	油豆腐	油豆腐	yeu deu vu
油坊	油坊	油坊	yeu faon
油光水滑	油光水滑	油光水滑	yeu kuaon syu waq
油燜茄	油焖茄	油燜茄	yeu mhen jie
油燜笋	油焖笋	油燜筍	yeu mhen syun
油氽果肉	油氽果肉	油氽果肉	yeu then kou gnioq
油燉	油炖	油燉	yeu ten
油丁	油丁	油丁	yeu tin
油搨黄	油搨黄	油搨黃	yeu thaq waon
油炸檜	油炸桧	油炸檜	yeu zaq kuei
油腳	油脚	油腳	yeu ciaq
油肉	油肉	油肉	yeu gnioq
遊碼頭	游码头	遊碼頭	yeu mo deu
游河	游河	游河	yeu ghou
釉璃家火	釉璃家火	釉璃家火	yeu li ko hou
魷魚	鱿鱼	魷魚	yeu ng
有	有	有	yeu4
有數	有数	有數	yeu su
有數目	有数目	有數目	yeu su moq
有數有目	有数有目	有數有目	yeu su yeu moq
有數目賬	有数目账	有數目賬	yeu su moq cian
有句閑話份	有句闲话份	有句閒話份	yeu ciu ghae wo ven
有陶成	有陶成	有陶成	yeu dau jin
有佬	有佬	有佬	yeu lau
有告	有告	有告	yeu kau
有要嘸緊	有要呒紧	有要嘸緊	yeu iau mh cin
有眼	有眼	有眼	yeu ngae
有還	有还	有還	yeu wae
有夥	有伙	有夥	yeu hou
有猛	有猛	有猛	yeu man
有生	有生	有生	yeu san
有身	有身	有身	yeu shin
有喜	有喜	有喜	yeu shi
有兩遭	有两遭	有兩遭	yeu lian tsau
有辰光	有辰光	有辰光	yeu zyun kuaon
有槍○	有枪○	有槍○	yeu chian
有相有量	有相有量	有相有量	yeu shian yeu lian
有商有量	有商有量	有商有量	yeu saon yeu lian
有晌	有晌	有晌	yeu zaon
有講嘸講	有讲呒讲	有講嘸講	yeu kaon mh kaon
有心相	有心相	有心相	yeu shin shian
有星○	有星○	有星○	yeu shin
有星○格	有星○格	有星○格	yeu shin kaq
有勒	有勒	有勒	yeu laq
有腳力	有脚力	有腳力	yeu ciaq liq
有嘸	有呒	有嘸	yeu mh
幽	幽	幽	ieu1
幽敦敦	幽敦敦	幽敦敦	ieu ten ten
幼稚園	幼稚园	幼稚園	ieu ji yu
幼兒園	幼儿园	幼兒園	ieu er yu
幼秀	幼秀	幼秀	ieu shieu
短	短	短	toe3
短褲	短裤	短褲	toe khu
短大衣	短大衣	短大衣	toe da i
短鱟	短鲎	短鱟	toe heu
短打	短打	短打	toe tan
短命	短命	短命	toe min
短命鬼	短命鬼	短命鬼	toe min ciu
短命撮死	短命撮死	短命撮死	toe min tshaq shi
短工	短工	短工	toe kon
短襪	短袜	短襪	toe maq
短統襪	短统袜	短統襪	toe thon maq
短促促	短促促	短促促	toe tshoq tshoq
☐	☐	☐	thoe1
☐頭	☐头	☐頭	thoe deu
團	团	團	doe2
團箕	团箕	團箕	doe ci
團匾	团匾	團匾	doe pi
團臍	团脐	團臍	doe ji
團鼓鼓	团鼓鼓	團鼓鼓	doe ku ku
團團	团团	團團	doe doe
團○唐○	团○唐○	團○唐○	doe daon
團○唐○婆	团○唐○婆	團○唐○婆	doe daon bou
團○唐○阿姆	团○唐○阿姆	團○唐○阿姆	doe daon an m
團熟	团熟	團熟	doe zoq
糰子	团子	糰子	doe tsy
段	段	段	doe6
段段落摜	段段落掼	段段落摜	doe doe loq guae
斷氣	断气	斷氣	doe chi
斷絞	断绞	斷絞	doe gau
斷掉	断掉	斷掉	doe diau
斷竅	断窍	斷竅	doe chiau
斷頭爛腳	断头烂脚	斷頭爛腳	doe deu lae ciaq
斷檔	断档	斷檔	doe taon
斷命	断命	斷命	doe min
斷命浮屍	断命浮尸	斷命浮屍	doe min veu sy
斷七	断七	斷七	doe chiq
囡	囡	囡	noe2
囡囡	囡囡	囡囡	nhoe nhoe
囡囡寶	囡囡宝	囡囡寶	nhoe nhoe pau
暖壺	暖壶	暖壺	noe wu
暖鍋	暖锅	暖鍋	noe kou
暖閣	暖阁	暖閣	noe koq
卵	卵	卵	loe4
卵子	卵子	卵子	loe tsy
卵脬	卵脬	卵脬	loe phau
卵脬皮	卵脬皮	卵脬皮	loe phau bi
卵毛	卵毛	卵毛	loe mau
卵瓜○瓜○	卵瓜○瓜○	卵瓜○瓜○	loe ko ko
卵袋	卵袋	卵袋	loe de
卵漿	卵浆	卵漿	loe cian
卵黄	卵黄	卵黃	loe uaon
卵袋黄	卵袋黄	卵袋黃	loe de uaon
亂	乱	亂	loe6
亂草字	乱草字	亂草字	loe tshau zy
亂話	乱话	亂話	loe wo
亂話到底	乱话到底	亂話到底	loe wo tau ti
亂話到地	乱话到地	亂話到地	loe wo tau di
亂…三千	乱…三千	亂…三千	loe sae chi
亂夢	乱梦	亂夢	loe maon
亂夢地裏	乱梦地里	亂夢地裏	loe maon di li
亂石牆	乱石墙	亂石牆	loe zaq zhian
亂七八糟	乱七八糟	亂七八糟	loe chiq paq tsau
杯	杯	杯	pei1
背大刀	背大刀	背大刀	pei dou tau
碑	碑	碑	pei1
褙襞	褙襞	褙襞	pei paq
背	背	揹	pei5
背利鈿	背利钿	揹利鈿	pei li di
背帶	背带	揹帶	pei ta
背帶褲	背带裤	揹帶褲	pei ta khu
背夜	背夜	揹夜	pei ya
背耙○	背耙○	揹耙○	pei bo
背老耙○	背老耙○	揹老耙○	pei lau bo
背木○梢○	背木○梢○	揹木○梢○	pei moq sau
背單	背单	背單	pei tae
背心	背心	背心	pei shin
背後	背后	背後	pei gheu
背後頭	背后头	背後頭	pei gheu deu
背命	背命	揹命	pei min
背風火	背风火	揹風火	pei fon hou
背桌凳腳	背桌凳脚	揹桌凳腳	pei tsoq ten ciaq
背脊心	背脊心	背脊心	pei ciq shin
背脊登	背脊登	背脊登	pei ciq ten
背胴	背胴	背胴	pei don
背脊	背脊	背脊	pei ciq
背脊骨	背脊骨	背脊骨	pei ciq kuaq
背柱骨	背柱骨	背柱骨	pei dzyu kuaq
辈份	辈份	輩份	pei ven
坯	坯	坯	phei1
坯子	坯子	坯子	phei tsy
配辦	配办	配辦	phei bae
配藥	配药	配藥	phei yaq
陪嫁	陪嫁	陪嫁	bei ko
陪人客	陪人客	陪人客	bei gnin khaq
背	背	背	bei6
背老老	背老老	背老老	bei lau lau
背時背得	背时背得	背時背得	bei zy bei taq
背書	背书	背書	bei syu
背陰	背阴	背陰	bei in
被告	被告	被告	bei kau
焙	焙	焙	bei6
玫瑰	玫瑰	玫瑰	mei kuei
玫瑰紅	玫瑰红	玫瑰紅	mei kuei ghon
枚	枚	枚	mei2
眉心	眉心	眉心	mei shin
眉筆	眉笔	眉筆	mei piq
梅	梅	梅	mei2
霉	霉	黴	mei2
梅子	梅子	梅子	mei tsy
梅時	梅时	梅時	mei zy
梅時裏	梅时里	梅時裏	mei zy li
梅汛裏	梅汛里	梅汛裏	mei shin li
梅花	梅花	梅花	mei huo
梅豆	梅豆	梅豆	mei deu
梅林鷄	梅林鸡	梅林雞	mei lin ci
梅魚	梅鱼	梅魚	mei ng
梅頭魚	梅头鱼	梅頭魚	mei deu ng
媒人	媒人	媒人	mei gnin
煤	煤	煤	mei2
煤球	煤球	煤球	mei jieu
煤球店	煤球店	煤球店	mei jieu ti
煤餅店	煤饼店	煤餅店	mei pin ti
煤球風籮○	煤球风箩○	煤球風籮○	mei jieu fon lou
煤球爐子	煤球炉子	煤球爐子	mei jieu lu tsy
煤爐	煤炉	煤爐	mei lu
煤灰	煤灰	煤灰	mei huei
煤頭紙	煤头纸	煤頭紙	mei deu tsy
煤餅	煤饼	煤餅	mei pin
霉千層	霉千层	黴千層	mei chi zen
霉乾菜	霉干菜	黴乾菜	mei kI tshe
霉頭脱腦	霉头脱脑	黴頭脫腦	mei deu thaq nau
霉豆腐	霉豆腐	黴豆腐	mei deu vu
謎子	谜子	謎子	mei tsy
妹妹	妹妹	妹妹	mhei mhei
每遭	每遭	每遭	mei tsau
每○心勿過	每○心勿过	每○心勿過	mei shin vaq kou
每日	每日	每日	mei gniq
妹夫	妹夫	妹夫	mei fu
美孚燈	美孚灯	美孚燈	mei fu ten
美人肩	美人肩	美人肩	mei gnin ci
美人肩	美人肩	美人肩	mei zyun ci
美人蕉	美人蕉	美人蕉	mei gnin ciau
美人蕉	美人蕉	美人蕉	mei zyun ciau
𤈦	𤈦	𤈦	mei6
𤈦焦	𤈦焦	𤈦焦	mei ciau
𤈦糊	𤈦糊	𤈦糊	mei wu
𤈦焦泥	𤈦焦泥	𤈦焦泥	mei ciau gni
𣍐	𠊉	𣍐	vei2
𣍐好	𠊉好	𣍐好	vei hau
𣍐話	𠊉话	𣍐話	vei wo
堆	堆	堆	tei1
堆頭	堆头	堆頭	tei deu
𠡒	𠡒	𠡒	tei3
𠡒布	𠡒布	𠡒布	tei pu
𠡒百筋	𠡒百筋	𠡒百筋	tei paq cin
𠡒腳	𠡒脚	𠡒腳	tei ciaq
對	对	對	tei5
對馬路	对马路	對馬路	tei mo lu
對蝦	对虾	對蝦	tei huo
對手	对手	對手	tei shieu
對過	对过	對過	tei kou
對頭	对头	對頭	tei deu
對河	对河	對河	tei ghou
對打	对打	對打	tei tan
對章	对章	對章	tei tsaon
對上	对上	對上	tei zaon
對江	对江	對江	tei kaon
對半夾起	对半夹起	對半夾起	tei pun kaq chi
對進	对进	對進	tei cin
對襟	对襟	對襟	tei cin
對攏	对拢	對攏	tei lon
對勿住	对勿住	對勿住	tei vaq dzyu
對勿起	对勿起	對勿起	tei vaq chi
對落	对落	對落	tei loq
對折攔腰環	对折拦腰环	對摺攔腰環	tei ciq lae iau guae
對出	对出	對出	tei tshyuq
推牌九	推牌九	推牌九	thei ba cieu
推扳	推扳	推扳	thei pae
推扳眼	推扳眼	推扳眼	thei pae ngae
推扳勿起	推扳勿起	推扳勿起	thei pae vaq chi
推板	推板	推板	thei pae
推爲	推为	推爲	thei wei
㷟	㷟	㷟	thei1
腿腈	腿腈	腿腈	thei cin
腿肉	腿肉	腿肉	thei gnioq
退皮	退皮	退皮	thei bi
退潮	退潮	退潮	thei jiau
退過	退过	退過	thei kou
退堂	退堂	退堂	thei daon
退庭	退庭	退庭	thei din
探監	探监	探監	thei kae
探口氣	探口气	探口氣	thei kheu chi
㶒	㶒	㶒	thei5
窞窞	窞窞	窞窞	dei dei
窞落	窞落	窞落	dei loq
兑姑嫂	兑姑嫂	兌姑嫂	dei ku sau
兑糖	兑糖	兌糖	dei daon
兑糖貨郎	兑糖货郎	兌糖貨郎	dei daon hou laon
兑糖個	兑糖个	兌糖個	dei daon goq
隊伙	队伙	隊夥	dei hou
隊伙家	队伙家	隊夥家	dei hou ko
紿	绐	紿	dei4
紿	绐	紿	de4
男家	男家	男家	nEI ko
男小頑	男小顽	男小頑	nEI shiau uae
男人	男人	男人	nEI gnin
男𡢿	男𡢿	男𡢿	nEI gnion
男人家	男人家	男人家	nEI gnin ko
男人客	男人客	男人客	nEI gnin khaq
南溪溫泉	南溪温泉	南溪溫泉	nEI chi uen dzOE
南瓜	南瓜	南瓜	nEI kuo
南貨店	南货店	南貨店	nEI hou ti
南半邊	南半边	南半邊	nEI pun pi
南面	南面	南面	nEI mi
楠木	楠木	楠木	nEI moq
内臓	内臓	內臓	nei dzaon
内行人	内行人	內行人	nei ghaon gnin
内八字	内八字	內八字	nei paq zy
内姪	内侄	內侄	nei jiq
内姪囡	内侄囡	內侄囡	nei jiq noe
𤿏	𤿏	𤿏	nei6
𤿏蒲蒲	𤿏蒲蒲	𤿏蒲蒲	nei bu bu
𤿏飯	𤿏饭	𤿏飯	nei vae
𡀂	𡀂	𡀂	lei2
雷	雷	雷	lei2
雷雨	雷雨	雷雨	lei yu
雷陣雨	雷阵雨	雷陣雨	lei jin yu
雷大	雷大	雷大	lei dou
雷大大	雷大大	雷大大	lei dou dou
雷打着𡀂	雷打着𡀂	雷打着𡀂	lei tan zyuq lei
洡	洡	洡	lei6
擂	擂	擂	lei6
擂倒	擂倒	擂倒	lei tau
擂倒牌子	擂倒牌子	擂倒牌子	lei tau ba tsy
擂沙圓	擂沙圆	擂沙圓	lei so yu
擂盤	擂盘	擂盤	lei bun
擂盆	擂盆	擂盆	lei ben
擂銅板	擂铜板	擂銅板	lei don pae
擂鐵環	擂铁环	擂鐵環	lei thiq guae
壘○魚	垒○鱼	壘○魚	lei ng
癗	癗	癗	lei4
錐子	锥子	錐子	tsei tsy
簪	簪	簪	tsEI1
醉鷄肉	醉鸡肉	醉雞肉	tsei ci gnioq
脆瓜	脆瓜	脆瓜	tshei kuo
⿱咋會	⿱咋会	⿱咋會	dzei2
雖則	虽则	雖則	sei tsaq
碎○	碎○	碎○	sei5
碎食	碎食	碎食	sei zhiq
嵗○氣	岁○气	歲○氣	sei chi
嵗○勃勃	岁○勃勃	歲○勃勃	sei baq baq
嵗○氣不剌	岁○气不剌	歲○氣不剌	sei chi paq laq
隨水	随水	隨水	zei syu
隨便渠法	随便渠法	隨便渠法	zei bi ji faq
隨便渠咋	随便渠咋	隨便渠咋	zei bi ji dza
隨面	随面	隨面	zei mi
隨路	随路	隨路	zei lu
隨到裏	随到里	隨到裏	zei tau li
隨到來	随到来	隨到來	zei tau le
隨嫁	随嫁	隨嫁	zei ko
隨嫁阿姆	随嫁阿姆	隨嫁阿姆	zei ko an m
隨手	随手	隨手	zei shieu
隨常	随常	隨常	zei dzaon
隨俉咋	随俉咋	隨俉咋	zei ng dza
蠶	蚕	蠶	zei2
蠶寶寶	蚕宝宝	蠶寶寶	zei pau pau
蠶蛾	蚕蛾	蠶蛾	zei ngou
蠶屙	蚕屙	蠶屙	zei ou
蠶蛹	蚕蛹	蠶蛹	zei ion3
罪過	罪过	罪過	zei kou
罪過不剌	罪过不剌	罪過不剌	zei kou paq laq
罪孽	罪孽	罪孽	zei gniq
熯	熯	熯	hEI5
含胡桃	含胡桃	含胡桃	ghEI wu dau
含羞草	含羞草	含羞草	ghEI shieu tshau
晐	晐	晐	ghEI2
晐到各采	晐到各采	晐到各采	ghEI tau koq tshe
晐到四采	晐到四采	晐到四采	ghEI tau sy tshe
晐到各處	晐到各处	晐到各處	ghEI tau koq tshyu
寒勢勢	寒势势	寒勢勢	ghEI syu syu
寒露	寒露	寒露	ghEI lu
寒毛	寒毛	寒毛	ghEI mau
寒毛管	寒毛管	寒毛管	ghEI mau kun
寒假	寒假	寒假	ghEI ko
寒酸相	寒酸相	寒酸相	ghEI soe shian
寒抖抖	寒抖抖	寒抖抖	ghEI teu teu
寒懍懍	寒懔懔	寒懍懍	ghEI lin lin
寒毛懍懍	寒毛懔懔	寒毛懍懍	ghEI mau lin lin
寒熱	寒热	寒熱	ghEI gniq
寒食	寒食	寒食	ghEI zhiq
汗滋滋	汗滋滋	汗滋滋	ghEI tsy tsy
汗潽一樣	汗潽一样	汗潽一樣	ghEI phu iq yan
汗爬雨淋	汗爬雨淋	汗爬雨淋	ghEI bo yu lin
汗斑	汗斑	汗斑	ghEI pae
汗衫	汗衫	汗衫	ghEI sae
汗衫背單	汗衫背单	汗衫背單	ghEI sae pei tae
汗背單	汗背单	汗背單	ghEI pei tae
汗衫背心	汗衫背心	汗衫背心	ghEI sae pei shin
汗背心	汗背心	汗背心	ghEI pei shin
汗酸臭	汗酸臭	汗酸臭	ghEI soe chieu
汗迹	汗迹	汗跡	ghEI ciq
汗出☐𤃀	汗出☐𤃀	汗出☐𤃀	ghEI tshyuq tho li
旱地	旱地	旱地	ghEI di
旱煙	旱烟	旱菸	ghEI i
旱煙管	旱烟管	旱菸管	ghEI i kun
安	安	安	EI1
安○板○一樣	安○板○一样	安○板○一樣	EI pae iq yan
安耽	安耽	安耽	EI tae
安安耽耽	安安耽耽	安安耽耽	EI EI tae tae
安牀	安床	安牀	EI zaon
安陰陽	安阴阳	安陰陽	EI in yan
哎	哎	哎	EI1
哎	哎	哎	ghEI2
哎	哎	哎	eu1
庵堂	庵堂	庵堂	EI daon
鵪鶉	鹌鹑	鵪鶉	EI zyun
按杖棒	按杖棒	按杖棒	EI jian baon
按拄棒	按拄棒	按拄棒	EI tsyu baon
案卷	案卷	案卷	EI ciu
暗	暗	暗	EI5
暗氣介	暗气介	暗氣介	EI chi ka
暗氣一樣	暗气一样	暗氣一樣	EI chi iq yan
暗手	暗手	暗手	EI shieu
暗探	暗探	暗探	EI thei
暗頭	暗头	暗頭	EI deu
暗頭裏	暗头里	暗頭裏	EI deu li
暗寸寸	暗寸寸	暗寸寸	EI tshen tshen
暗洞洞	暗洞洞	暗洞洞	EI don don
暗弄慫	暗弄怂	暗弄慫	EI lon son
暗肉	暗肉	暗肉	EI gnioq
暗笛薄龍	暗笛薄龙	暗笛薄龍	EI diq boq lon
暗鐵撲龍	暗铁扑龙	暗鐵撲龍	EI thiq phoq lon
暗出出	暗出出	暗出出	EI tshyuq tshyuq
癸	癸	癸	kuei1
規	规	規	kuei1
桂皮	桂皮	桂皮	kuei bi
桂圓	桂圆	桂圓	kuei yu
桂圓肉	桂圆肉	桂圓肉	kuei yu gnioq
桂花	桂花	桂花	kuei huo
桂花蒸	桂花蒸	桂花蒸	kuei huo cin
會計	会计	會計	kuei ci
鱖魚	鳜鱼	鱖魚	kuei ng
虧空	亏空	虧空	khuei khon
塊	块	塊	khuei3
塊碼	块码	塊碼	khuei mo
塊頭	块头	塊頭	khuei deu
塊肉	块肉	塊肉	khuei gnioq
⿰米鬼	⿰米鬼	⿰米鬼	khuei5
灰	灰	灰	huei1
灰鼠	灰鼠	灰鼠	huei tshyu
灰沙	灰沙	灰沙	huei so
灰蛋	灰蛋	灰蛋	huei dae
灰背	灰背	灰背	huei pei
灰籮倒掉	灰箩倒掉	灰籮倒掉	huei lou tau diau
灰孫子	灰孙子	灰孫子	huei sen tsy
灰塵	灰尘	灰塵	huei jin
灰塵彭塳	灰尘彭塳	灰塵彭塳	huei jin ban bon
灰撲撲	灰扑扑	灰撲撲	huei phoq phoq
灰的剝落	灰的剥落	灰的剝落	huei tiq poq loq
灰鐵撲落	灰铁扑落	灰鐵撲落	huei thiq phoq loq
灰汁糰	灰汁团	灰汁糰	huei ciq doe
悔棋	悔棋	悔棋	huei ji
悔煞	悔煞	悔煞	huei saq
晦氣	晦气	晦氣	huei chi
回	回	回	wei2
回轉去	回转去	回轉去	wei tsoe chi
回轉來	回转来	回轉來	wei tsoe le
回頭	回头	回頭	wei deu
回頭人	回头人	回頭人	wei deu gnin
回訪	回访	回訪	wei faon
回湯豆腐乾	回汤豆腐干	回湯豆腐乾	wei thaon deu vu kI
回門	回门	回門	wei men
回生○	回生○	回生○	wei sen
回屋落	回屋落	回屋落	wei oq loq
危險八剌	危险八剌	危險八剌	wei shi paq laq
茴香	茴香	茴香	wei shian
茴香倭豆	茴香倭豆	茴香倭豆	wei shian ou deu
桅桿	桅杆	桅杆	wei kI
圍棋	围棋	圍棋	wei ji
圍牆	围墙	圍牆	wei zhian
槐樹	槐树	槐樹	wei zyu
胃氣痛	胃气痛	胃氣痛	wei chi thon
胃家	胃家	胃家	wei ko
胃	胃	胃	wei6
胃口	胃口	胃口	wei kheu
胃病	胃病	胃病	wei bin
爲仔	为仔	爲仔	wei tsy
爲仔講	为仔讲	爲仔講	wei tsy kaon
會鈔	会钞	會鈔	wei tshau
匯角	汇角	匯角	wei koq
匯角沿	汇角沿	匯角沿	wei koq yi
匯角頭	汇角头	匯角頭	wei koq deu
緯絲	纬丝	緯絲	wei sy
衛生褲	卫生裤	衛生褲	wei sen khu
衛生衫	卫生衫	衛生衫	wei sen sae
衛生間	卫生间	衛生間	wei sen kae
萎	萎	萎	uei1
萎篤篤	萎笃笃	萎篤篤	uei toq toq
萎頭萎腦	萎头萎脑	萎頭萎腦	uei deu uei nau
煨番薯	煨番薯	煨番薯	uei fae zyu
委○糊○	委○糊○	委○糊○	uei wu
波斯貓	波斯猫	波斯貓	pou sy mae
菠蘿	菠萝	菠蘿	pou lou
菠薐	菠薐	菠薐	pou len
菠菜	菠菜	菠菜	pou tshe
坡地	坡地	坡地	phou di
破裏破色	破里破色	破裏破色	phou li phou saq
破鞋爿	破鞋爿	破鞋爿	phou gha bae
破鈔	破钞	破鈔	phou tshau
婆家	婆家	婆家	bou ko
婆婆	婆婆	婆婆	bou bou
縛	缚	縛	bou6
模子	模子	模子	mou tsy
模糊	模糊	模糊	mou wu
模糊結夾	模糊结夹	模糊結夾	mou wu ciq kaq
磨	磨	磨	mou2
磨剪刀鏟薄刀	磨剪刀铲薄刀	磨剪刀鏟薄刀	mou ci tau tshae boq tau
磨剪刀鏟薄刀	磨剪刀铲薄刀	磨剪刀鏟薄刀	mou ci tau tshae baq tau
磨牙齒	磨牙齿	磨牙齒	mou ngo tsy
磨擔	磨担	磨擔	mou tae
磨坊	磨坊	磨坊	mou faon
磨盤	磨盘	磨盤	mou bun
磨柄	磨柄	磨柄	mou pin
磨心	磨心	磨心	mou shin
磨肚臍	磨肚脐	磨肚臍	mou du ji
磨洞眼	磨洞眼	磨洞眼	mou don ngae
磨墨	磨墨	磨墨	mou moq
蘑菇	蘑菇	蘑菇	mou ku
墓	墓	墓	mou6
墓碑	墓碑	墓碑	mou pei
多	多	多	tou1
多嘴	多嘴	多嘴	tou tsyu
多嘴活孫	多嘴活孙	多嘴活孫	tou tsyu waq sen
多…連帳	多…连帐	多…連帳	tou li cian
多老娘鈿	多老娘钿	多老孃鈿	tou lau gnian di
多少	多少	多少	tou shiau
多少個	多少个	多少個	tou shiau kou
多少個	多少个	多少個	tou shiau goq
多講多話	多讲多话	多講多話	tou kaon tou wo
多講多得	多讲多得	多講多得	tou kaon tou taq
多心	多心	多心	tou shin
…多星○	…多星○	…多星○	tou shin
多眨眼	多眨眼	多眨眼	tou saq ngae
多肉	多肉	多肉	tou gnioq
拖	拖	拖	thou1
拖	拖	拖	tha1
拖鷄豹	拖鸡豹	拖雞豹	thou ci pau
拖鞋	拖鞋	拖鞋	thou gha
鞋	鞋	鞋	gha2
拖下飯	拖下饭	拖下飯	thou gho vae
拖油瓶	拖油瓶	拖油瓶	thou yeu bin
拖○黄	拖○黄	拖○黃	thou waon
拖○得斯黄	拖○得斯黄	拖○得斯黃	thou taq sy waon
拖畚	拖畚	拖畚	thou fon
拖畚布	拖畚布	拖畚布	thou fon pu
拖畚柄	拖畚柄	拖畚柄	thou fon pin
拖鼻頭	拖鼻头	拖鼻頭	thou baq deu
馱	驮	馱	dou2
駝背	驼背	駝背	dou pei
大	大	大	dou6
大指末頭	大指末头	大指末頭	dou tsy maq deu
大嘴脯	大嘴脯	大嘴脯	dou tsyu bu
大嘴巴	大嘴巴	大嘴巴	dou tsyu po
大櫥	大橱	大櫥	dou dzyu
大尿	大尿	大尿	dou syu
大尿布頭	大尿布头	大尿布頭	dou syu pu deu
大水	大水	大水	dou syu
大暑	大暑	大暑	dou syu
大米	大米	大米	dou mi
大天白亮	大天白亮	大天白亮	dou thi baq lian
大天亮	大天亮	大天亮	dou thi lian
大氣	大气	大氣	dou chi
大年	大年	大年	dou gni
大年初一	大年初一	大年初一	dou gni tshu iq
大年夜	大年夜	大年夜	dou gni ya
大年三十	大年三十	大年三十	dou gni sae zyuq
大前年	大前年	大前年	dou zhi gni
大前日	大前日	大前日	dou zhi gniq
大肚皮	大肚皮	大肚皮	dou du bi
大路	大路	大路	dou lu
大蘇篮	大苏篮	大蘇籃	dou su lae
大姑娘	大姑娘	大姑娘	dou ku gnian
大糊	大糊	大糊	dou wu
大糊結夾	大糊结夹	大糊結夾	dou wu ciq kaq
大糊其其	大糊其其	大糊其其	dou wu ji ji
大糊稀稀	大糊稀稀	大糊稀稀	dou wu shi shi
大糊性轟	大糊性轰	大糊性轟	dou wu shin hon
大排	大排	大排	dou ba
大姐	大姐	大姐	dou cia
大泡辣椒	大泡辣椒	大泡辣椒	dou phau laq ciau
大炮	大炮	大炮	dou phau
大炮仗	大炮仗	大炮仗	dou phau jian
大毛病	大毛病	大毛病	dou mau bin
大帽	大帽	大帽	dou mau
大箌	大箌	大箌	dou dau
大大箌箌	大大箌箌	大大箌箌	dou dou dau dau
大好老	大好老	大好老	dou hau lau
大貨癩施○	大货癞施○	大貨癩施○	dou hou la sy
大老倌	大老倌	大老倌	dou lau kun
大牙	大牙	大牙	dou ngo
大條	大条	大條	dou diau
大花臉	大花脸	大花臉	dou huo li
大戤戤	大戤戤	大戤戤	dou ge ge
大眼睩索	大眼睩索	大眼睩索	dou ngae loq soq
大囡	大囡	大囡	dou noe
大卵袋	大卵袋	大卵袋	dou loe de
大推大扳	大推大扳	大推大扳	dou thei dou pae
大差大扳	大差大扳	大差大扳	dou tsho dou pae
大寒	大寒	大寒	dou ghEI
大塊頭	大块头	大塊頭	dou khuei deu
大大前日	大大前日	大大前日	dou dou zhi gniq
大大後日	大大后日	大大後日	dou dou gheu gniq
大大阿姆	大大阿姆	大大阿姆	dou dou an m
大鑼瘡	大锣疮	大鑼瘡	dou lou tshaon
大頭	大头	大頭	dou deu
大頭菜	大头菜	大頭菜	dou deu tshe
大頭梅蒜	大头梅蒜	大頭梅蒜	dou deu mei soe
大頭大腦	大头大脑	大頭大腦	dou deu dou nau
大頭頭	大头头	大頭頭	dou deu deu
大頭頸	大头颈	大頭頸	dou deu cin
大頭殼子	大头壳子	大頭殼子	dou deu khoq tsy
大頭别針	大头别针	大頭別針	dou deu biq cin
大頭魚鮝烤肉	大头鱼鲞烤肉	大頭魚鯗烤肉	dou deu ng shian khau gnioq
大後年	大后年	大後年	dou gheu gni
大後日	大后日	大後日	dou gheu gniq
大彭彭	大彭彭	大彭彭	dou ban ban
大生日	大生日	大生日	dou san gniq
大腸	大肠	大腸	dou jian
大胖嘵豬	大胖哓猪	大胖嘵豬	dou phaon gniau tsyu
大房東	大房东	大房東	dou vaon ton
大池	大池	大池	dou ji
大湯	大汤	大湯	dou thaon
大黄魚	大黄鱼	大黃魚	dou waon ng
大半日	大半日	大半日	dou pun gniq
大門	大门	大門	dou men
大門口	大门口	大門口	dou men kheu
大餅	大饼	大餅	dou pin
大餅攤	大饼摊	大餅攤	dou pin thae
大襟	大襟	大襟	dou cin
大襟布衫	大襟布衫	大襟布衫	dou cin pu sae
大人	大人	大人	dou gnin
大人體料	大人体料	大人體料	dou gnin thi liau
大印	大印	大印	dou in
大白	大白	大白	dou baq
大白靈性	大白灵性	大白靈性	dou baq lin shin
大麥	大麦	大麥	dou maq
大衲	大衲	大衲	dou naq
大隻小	大只小	大隻小	dou tsaq shiau
大閘蟹	大闸蟹	大閘蟹	dou zaq ha
大阿哥	大阿哥	大阿哥	dou aq kou
大阿福	大阿福	大阿福	dou aq foq
大腳痱子	大脚痱子	大腳痱子	dou ciaq fi tsy
大腳娘姨	大脚娘姨	大腳孃姨	dou ciaq gnian yi
大腳髈	大脚髈	大腳髈	dou ciaq phaon
大腳風	大脚风	大腳風	dou ciaq fon
大撲撲	大扑扑	大撲撲	dou phoq phoq
大雪	大雪	大雪	dou syuq
大筆頭	大笔头	大筆頭	dou piq deu
大舌頭	大舌头	大舌頭	dou zhiq deu
大一眼	大一眼	大一眼	dou iq ngae
大眼	大眼	大眼	dou ngae
大兒子	大儿子	大兒子	dou ng tsy
舵	舵	舵	dou4
挼	挼	挼	nou2
儂	侬	儂	nou6
儂個	侬个	儂個	nou goq
糯	糯	糯	nou6
糯米	糯米	糯米	nou mi
糯米飯蝦	糯米饭虾	糯米飯蝦	nou mi vae huo
腡	脶	腡	lou2
腡底	脶底	腡底	lou ti
腡頂	脶顶	腡頂	lou tin
腡紋	脶纹	腡紋	lou ven
羅漢	罗汉	羅漢	lou he
羅漢豆	罗汉豆	羅漢豆	lou he deu
羅宋帽	罗宋帽	羅宋帽	lou son mau
蘿蔔	萝卜	蘿蔔	lou boq
蘿蔔絲刨	萝卜丝刨	蘿蔔絲刨	lou boq sy bau
蘿蔔乾	萝卜干	蘿蔔乾	lou boq kI
蘿蔔菜	萝卜菜	蘿蔔菜	lou boq tshe
籮	箩	籮	lou2
籮窠	箩窠	籮窠	lou khou
鑼鼓腳	锣鼓脚	鑼鼓腳	lou ku ciaq
囉唆	啰唆	囉唆	lhou sou
囉裏百唆	啰里百唆	囉裏百唆	lhou li paq sou
攎	攎	攎	lou4
攎順毛	攎顺毛	攎順毛	lou zyun mau
邏	逻	邏	lou6
…左右	…左右	…左右	tsou yeu
做	做	做	tsou5
做市	做市	做市	tsou zy
做事體	做事体	做事體	tsou zy thi
做眯眼	做眯眼	做眯眼	tsou mhi ngae
做地頭	做地头	做地頭	tsou di deu
做地𡍲	做地𡍲	做地𡍲	tsou di taq
做繭	做茧	做繭	tsou ci
做忌日	做忌日	做忌日	tsou ji gniq
做忌日羹飯	做忌日羹饭	做忌日羹飯	tsou ji gniq kan vae
做戲文	做戏文	做戲文	tsou shi ven
做衣裳	做衣裳	做衣裳	tsou i zaon
做意○房	做意○房	做意○房	tsou i vaon
做無賴	做无赖	做無賴	tsou Wu la
做夜作	做夜作	做夜作	tsou ya tsoq
做道場	做道场	做道場	tsou dau jian
做家	做家	做家	tsou ko
做人家	做人家	做人家	tsou gnin ko
做瓦筒個	做瓦筒个	做瓦筒個	tsou ngo don goq
做小貨	做小货	做小貨	tsou shiau hou
做話柄	做话柄	做話柄	tsou wo pin
做三朝	做三朝	做三朝	tsou sae jiau
做手腳	做手脚	做手腳	tsou shieu ciaq
做亂夢	做乱梦	做亂夢	tsou loe maon
做坯	做坯	做坯	tsou phei
做媒	做媒	做媒	tsou mei
做謎子	做谜子	做謎子	tsou mei tsy
做隊	做队	做隊	tsou dei
做做隊	做做队	做做隊	tsou tsou dei
做大水	做大水	做大水	tsou dou syu
做頭	做头	做頭	tsou deu
做頭髮	做头发	做頭髮	tsou deu faq
做綳子	做绷子	做繃子	tsou pan tsy
做花綳	做花绷	做花繃	tsou huo pan
做花	做花	做花	tsou huo
做冷訊	做冷讯	做冷訊	tsou lan shin
做生	做生	做生	tsou san
做生意	做生意	做生意	tsou san i
做生活	做生活	做生活	tsou san wo
做生姆	做生姆	做生姆	tsou san m
做山○	做山○	做山○	tsou sae
做賬	做账	做賬	tsou cian
做秧田	做秧田	做秧田	tsou ian di
做傷	做伤	做傷	tsou saon
做病	做病	做病	tsou bin
做筋骨	做筋骨	做筋骨	tsou cin kuaq
做人	做人	做人	tsou gnin
做人勿來	做人勿来	做人勿來	tsou gnin vaq le
做人客	做人客	做人客	tsou gnin khaq
做新婦	做新妇	做新婦	tsou shin vu
做風水	做风水	做風水	tsou fon syu
做重梅	做重梅	做重梅	tsou dzon mei
做重霉	做重霉	做重黴	tsou dzon mei
做功	做功	做功	tsou kon
做功德	做功德	做功德	tsou kon taq
做撥	做拨	做撥	tsou paq
做仔	做仔	做仔	tsou tsy
做佛事	做佛事	做佛事	tsou vaq zy
做色做樣	做色做样	做色做樣	tsou saq tsou yan
做腳	做脚	做腳	tsou ciaq
做作	做作	做作	tsou tsoq
做七頭	做七头	做七頭	tsou chiq deu
搓	搓	搓	tshou1
錯拼	错拼	錯拼	tshou phin
錯落	错落	錯落	tshou loq
啥辰光	啥辰光	啥辰光	sou zyun kuaon
啥辰光	啥辰光	啥辰光	soq zyun kuaon
梭子	梭子	梭子	sou tsy
鎖	锁	鎖	sou3
鎖片	锁片	鎖片	sou phi
鎖眼	锁眼	鎖眼	sou ngae
坐起間	坐起间	坐起間	zou chi kae
坐帶起來	坐带起来	坐帶起來	zou ta chi le
坐帶起來	坐带起来	坐帶起來	zou tae chi le
坐牢監	坐牢监	坐牢監	zou lau kae
坐監牢	坐监牢	坐監牢	zou kae lau
坐車	坐车	坐車	zou tsho
坐待筵	坐待筵	坐待筵	zou de yi
坐板瘡	坐板疮	坐板瘡	zou pae tshaon
坐窠	坐窠	坐窠	zou khou
坐相	坐相	坐相	zou shian
坐堂	坐堂	坐堂	zou daon
坐莊客人	坐庄客人	坐莊客人	zou tsaon khaq gnin
座	座	座	zou4
座○	座○	座○	zou4
座墊	座垫	座墊	zou di
哥哥	哥哥	哥哥	kou kou
鍋貼	锅贴	鍋貼	kou thiaq
果○鍬	果○锹	果○鍬	kou chiau
果盤	果盘	果盤	kou bun
果桶	果桶	果桶	kou don
果肉	果肉	果肉	kou gnioq
裹	裹	裹	kou3
裹腿	裹腿	裹腿	kou thei
裹餛飩	裹馄饨	裹餛飩	kou wen den
個	个	個	kou5
個子頭	个子头	個子頭	kou tsy deu
個數	个数	個數	kou su
個把個	个把个	個把個	kou po goq
過	过	過	kou5
過世	过世	過世	kou syu
過歲	过岁	過歲	kou syu
過繼	过继	過繼	kou ci
…過去	…过去	…過去	kou chi
過瘾	过瘾	過癮	kou gni
過户	过户	過戶	kou wu
過街樓	过街楼	過街樓	kou ka leu
過夜	过夜	過夜	kou ya
過道	过道	過道	kou dau
過路	过路	過路	kou lu
過老酒	过老酒	過老酒	kou lau cieu
過橋	过桥	過橋	kou jiau
過飯	过饭	過飯	kou vae
過頭	过头	過頭	kou deu
過頭勢	过头势	過頭勢	kou deu syu
過賬	过账	過賬	kou cian
過賬簿	过账簿	過賬簿	kou cian bu
過簿	过簿	過簿	kou bu
過賬洋鈿	过账洋钿	過賬洋鈿	kou cian yan di
過堂	过堂	過堂	kou daon
過門	过门	過門	kou men
過興○	过兴○	過興○	kou shin
過雷雨	过雷雨	過雷雨	kou lei yu
過格	过格	過格	kou kaq
科	科	科	khou1
棵	棵	棵	khou1
窠	窠	窠	khou1
窠座	窠座	窠座	khou zou
可	可	可	khou3
可憐	可怜	可憐	khou li
可惡	可恶	可惡	khou u
可可看	可可看	可可看	khou khou khI
課	课	課	khou5
課堂	课堂	課堂	khou daon
課本	课本	課本	khou pen
騍馬	骒马	騍馬	khou mo
鵝	鹅	鵝	ngou2
鵝毛扇	鹅毛扇	鵝毛扇	ngou mau shi
鵝毛月	鹅毛月	鵝毛月	ngou mau yuq
鵝蛋臉	鹅蛋脸	鵝蛋臉	ngou dae li
鵝娘	鹅娘	鵝娘	ngou gnian
鵝掌風	鹅掌风	鵝掌風	ngou tsaon fon
鵝黄	鹅黄	鵝黃	ngou waon
鵝瘃	鹅瘃	鵝瘃	ngou tsoq
餓齋	饿斋	餓齋	ngou tsa
☐	☐	☐	hou1
火字旁	火字旁	火字旁	hou zy baon
火添○	火添○	火添○	hou thi
火鏟	火铲	火鏟	hou tshae
火氣	火气	火氣	hou chi
火鉗	火钳	火鉗	hou ji
火杴	火锨	火杴	hou shi
火櫃頭	火柜头	火櫃頭	hou jiu deu
火櫃	火柜	火櫃	hou jiu
火櫃矮凳	火柜矮凳	火櫃矮凳	hou jiu a ten
火槽○病	火槽○病	火槽○病	hou zau bin
火耙	火耙	火耙	hou bo
火車	火车	火車	hou tsho
火車路	火车路	火車路	hou tsho lu
火車站	火车站	火車站	hou tsho dzae
火錶	火表	火錶	hou piau
火穿○	火穿○	火穿○	hou tshOE
火油	火油	火油	hou yeu
火油箱	火油箱	火油箱	hou yeu shian
火油燈	火油灯	火油燈	hou yeu ten
火煤頭	火煤头	火煤頭	hou mei deu
火腿	火腿	火腿	hou thei
火甏	火甏	火甏	hou ban
火燙	火烫	火燙	hou thaon
火火燙	火火烫	火火燙	hou hou thaon
火倉	火仓	火倉	hou tshaon
火缸	火缸	火缸	hou kaon
火管	火管	火管	hou kun
火盆	火盆	火盆	hou ben
火輪	火轮	火輪	hou len
火螢頭	火萤头	火螢頭	hou yin deu
火種菩薩	火种菩萨	火種菩薩	hou tson bu saq
火種彭○生	火种彭○生	火種彭○生	hou tson ban san
火銃	火铳	火銃	hou tshon
火炦臭	火炦臭	火炦臭	hou baq chieu
火着	火着	火着	hou jiaq
火燭	火烛	火燭	hou tsoq
火促○鏈	火促○链	火促○鏈	hou tshoq li
火灼糕	火灼糕	火灼糕	hou ciq kau
火熱烔	火热烔	火熱烔	hou gniq don
火熱涾涾滚	火热涾涾滚	火熱涾涾滾	hou gniq daq daq kuen
伙計	伙计	夥計	hou ci
伙頭軍	伙头军	伙頭軍	hou deu ciun
伙食	伙食	伙食	hou zhiq
火食	火食	火食	hou zhiq
呵呵	呵呵	呵呵	hou hou
貨車	货车	貨車	hou tsho
貨棧	货栈	貨棧	hou dzae
貨頭	货头	貨頭	hou deu
貨郎擔	货郎担	貨郎擔	hou laon tae
貨色	货色	貨色	hou saq
禾木旁	禾木旁	禾木旁	ghou moq baon
和	和	和	ghou2
和坒	和坒	和坒	ghou bi
和棋	和棋	和棋	ghou ji
和排	和排	和排	ghou ba
和家	和家	和家	ghou ko
和家老小	和家老小	和家老小	ghou ko lau shiau
和消頭	和消头	和消頭	ghou shiau deu
和個	和个	和個	ghou kou
和頭	和头	和頭	ghou deu
和尚	和尚	和尚	ghou zaon
和尚蟹	和尚蟹	和尚蟹	ghou zaon ha
和尚廟	和尚庙	和尚廟	ghou zaon miau
和尚餅	和尚饼	和尚餅	ghou zaon pin
和總	和总	和總	ghou tson
和落三姆	和落三姆	和落三姆	ghou loq sae m
河	河	河	ghou2
河屍鬼	河尸鬼	河屍鬼	ghou sy ciu
河邊頭	河边头	河邊頭	ghou pi deu
河裏	河里	河裏	ghou li
河鯽魚	河鲫鱼	河鯽魚	ghou ci ng
河鯽魚烤葱	河鲫鱼烤葱	河鯽魚烤蔥	ghou ci ng khau tshon
河泥	河泥	河泥	ghou gni
河泥罱	河泥罱	河泥罱	ghou gni ne
河埠頭	河埠头	河埠頭	ghou bu deu
河灘	河滩	河灘	ghou thae
河灘邊頭	河滩边头	河灘邊頭	ghou thae pi deu
河姆渡遺址	河姆渡遗址	河姆渡遺址	ghou meu du yi tsy
河姆渡遺址	河姆渡遗址	河姆渡遺址	ghou m du yi tsy
河頭	河头	河頭	ghou deu
河浜	河浜	河浜	ghou pan
河蚌	河蚌	河蚌	ghou ban
河塘	河塘	河塘	ghou daon
河豚	河豚	河豚	ghou den
荷包蛋	荷包蛋	荷包蛋	ghou pau dae
荷花	荷花	荷花	ghou huo
荷蘭水	荷兰水	荷蘭水	ghou lae syu
荷藕	荷藕	荷藕	ghou ngeu
荷葉	荷叶	荷葉	ghou yiq
荷葉邊	荷叶边	荷葉邊	ghou yiq pi
倭肩	倭肩	倭肩	ou ci
倭妥	倭妥	倭妥	ou thou
倭豆	倭豆	倭豆	ou deu
大倭豆	大倭豆	大倭豆	dou ou deu
倭豆芽	倭豆芽	倭豆芽	ou deu ngo
捼腳	捼脚	捼腳	ou ciaq
捼	捼	捼	ou1
捼鷄賊	捼鸡贼	捼雞賊	ou ci zaq
捼浜	捼浜	捼浜	ou pan
窩風	窝风	窩風	ou fon
𤉦暖	𤉦暖	𤉦暖	ou noe
屙	屙	屙	ou5
屙嘴疙得	屙嘴疙得	屙嘴疙得	ou tsyu kaq taq
屙注蒼蠅	屙注苍蝇	屙注蒼蠅	ou tsyu tshaon in
屙裏拌糟	屙里拌糟	屙裏拌糟	ou li bun tsau
屙泥脾氣	屙泥脾气	屙泥脾氣	ou gni bi chi
屙道頭	屙道头	屙道頭	ou dau deu
屙榨貓	屙榨猫	屙榨貓	ou tso mae
屙榨貓壓牢𡀂	屙榨猫压牢𡀂	屙榨貓壓牢𡀂	ou tso mae aq lau lei
屙車	屙车	屙車	ou tsho
屙蛋分	屙蛋分	屙蛋分	ou dae fen
屙𤿏屁鬆	屙𤿏屁松	屙𤿏屁鬆	ou nei phi son
屙坑間	屙坑间	屙坑間	ou khan kae
屙坑	屙坑	屙坑	ou khan
屙缸	屙缸	屙缸	ou kaon
屙缸砂	屙缸砂	屙缸砂	ou kaon so
屙浸草	屙浸草	屙浸草	ou cin tshau
屙蟲	屙虫	屙蟲	ou dzon
屙末爛脆	屙末烂脆	屙末爛脆	ou maq lae tshei
屙塞煞	屙塞煞	屙塞煞	ou saq saq
屙塞飽	屙塞饱	屙塞飽	ou saq pau
屙塞頭底心	屙塞头底心	屙塞頭底心	ou saq deu ti shin
屙撲	屙扑	屙撲	ou phoq
屙撲丁	屙扑丁	屙撲丁	ou phoq tin
屙撲精	屙扑精	屙撲精	ou phoq cin
牡丹	牡丹	牡丹	meu tae
浮屍	浮尸	浮屍	veu sy
浮面	浮面	浮面	veu mi
浮瓢	浮瓢	浮瓢	veu biau
浮薸	浮薸	浮薸	veu biau
浮浮	浮浮	浮浮	veu veu
兜	兜	兜	teu1
兜尿布	兜尿布	兜尿布	teu syu pu
兜圈子	兜圈子	兜圈子	teu chiu tsy
兜心	兜心	兜心	teu shin
兜勒轉	兜勒转	兜勒轉	teu laq tsoe
斗篷	斗篷	斗篷	teu bon
鬥	斗	鬥	teu5
鬥水	斗水	鬥水	teu syu
鬥鷄眼	斗鸡眼	鬥雞眼	teu ci ngae
鬥當中	斗当中	鬥當中	teu taon tson
鬥風	斗风	鬥風	teu fon
偷飯烏龜	偷饭乌龟	偷飯烏龜	theu vae u ciu
偷生爿	偷生爿	偷生爿	theu san bae
偷窗白眼	偷窗白眼	偷窗白眼	theu tshaon baq ngae
偷盤	偷盘	偷盤	theu bun
偷針	偷针	偷針	theu cin
斢	斢	斢	theu1
㪗	㪗	㪗	theu3
透	透	透	theu5
透鮮	透鲜	透鮮	theu shi
透刮鮮	透刮鲜	透刮鮮	theu kuaq shi
透刮斯鮮	透刮斯鲜	透刮斯鮮	theu kuaq sy shi
透新鮮	透新鲜	透新鮮	theu shin shi
透刮新鮮	透刮新鲜	透刮新鮮	theu kuaq shin shi
投	投	投	deu2
投投動	投投动	投投動	deu deu don
投孫	投孙	投孫	deu sen
投孫鬼	投孙鬼	投孫鬼	deu sen ciu
投孫活鬼	投孙活鬼	投孫活鬼	deu sen waq ciu
投井	投井	投井	deu cin
投人身	投人身	投人身	deu gnin shin
投出	投出	投出	deu tshyuq
頭過	头过	頭過	deu kou
投五投六	投五投六	投五投六	deu ng deu loq
投七投八	投七投八	投七投八	deu chiq deu paq
頭	头	頭	deu2
頭…	头…	頭…	deu2
頭子	头子	頭子	deu tsy
頭處飯	头处饭	頭處飯	deu tshyu vae
頭皮	头皮	頭皮	deu bi
頭面	头面	頭面	deu mi
頭底心	头底心	頭底心	deu ti shin
頭鈿	头钿	頭鈿	deu di
頭裏	头里	頭裏	deu li
頭起家	头起家	頭起家	deu chi ko
頭起頭	头起头	頭起頭	deu chi deu
頭路	头路	頭路	deu lu
頭埭	头埭	頭埭	deu da
頭毛	头毛	頭毛	deu mau
頭髮	头发	頭髮	deu faq
頭毛○	头毛○	頭毛○	deu mau
頭毛○子	头毛○子	頭毛○子	deu mau tsy
頭回	头回	頭回	deu wei
頭回子	头回子	頭回子	deu wei tsy
頭剛	头刚	頭剛	deu kaon
頭剛子	头刚子	頭剛子	deu kaon tsy
頭家	头家	頭家	deu ko
頭枷鎖	头枷锁	頭枷鎖	deu ko sou
頭挑	头挑	頭挑	deu thiau
頭抬起	头抬起	頭擡起	deu de chi
頭油	头油	頭油	deu yeu
頭塊牌子	头块牌子	頭塊牌子	deu khuei ba tsy
頭大	头大	頭大	deu da
頭大不剌	头大不剌	頭大不剌	deu da paq laq
頭窠蛋	头窠蛋	頭窠蛋	deu khou dae
頭頭	头头	頭頭	deu deu
頭頭順流	头头顺流	頭頭順流	deu deu zyun lieu
頭生	头生	頭生	deu san
頭兩里路	头两里路	頭兩里路	deu lian li lu
頭兩畝	头两亩	頭兩畝	deu lian m
頭寸	头寸	頭寸	deu tshen
頭頸刨	头颈刨	頭頸刨	deu cin bau
頭頸骨	头颈骨	頭頸骨	deu cin kuaq
頭頸	头颈	頭頸	deu cin
頭頸骨𢺴出	头颈骨𢺴出	頭頸骨𢺴出	deu cin kuaq iuq tshyuq
頭痛膨脹	头痛膨胀	頭痛膨脹	deu thon ban cian
頭暈	头晕	頭暈	deu yun
頭渾	头浑	頭渾	deu wen
頭扤扤	头扤扤	頭扤扤	deu nghaq nghaq
頭扤扤	头扤扤	頭扤扤	deu ngaq ngaq
頭伏	头伏	頭伏	deu voq
頭汁	头汁	頭汁	deu ciq
頭七	头七	頭七	deu chiq
頭出角	头出角	頭出角	deu tshyuq koq
豆豉醬	豆豉酱	豆豉醬	deu zy cian
豆腐	豆腐	豆腐	deu vu
豆腐皮	豆腐皮	豆腐皮	deu vu bi
豆腐腦	豆腐脑	豆腐腦	deu vu nau
豆腐花	豆腐花	豆腐花	deu vu huo
豆腐飯	豆腐饭	豆腐飯	deu vu vae
豆腐漿	豆腐浆	豆腐漿	deu vu cian
豆酥糖	豆酥糖	豆酥糖	deu su daon
豆沙色	豆沙色	豆沙色	deu so saq
豆板	豆板	豆板	deu pae
豆板醬	豆板酱	豆板醬	deu pae cian
豆油	豆油	豆油	deu yeu
豆青	豆青	豆青	deu chin
豆莢	豆荚	豆莢	deu ciaq
豆莢乾	豆荚干	豆莢乾	deu ciaq kI
豆稭稈	豆稭秆	豆稭稈	deu ciq kI
鏤	镂	鏤	lheu1
鏤眼	镂眼	鏤眼	lheu ngae
鏤鏤挖挖	镂镂挖挖	鏤鏤挖挖	lheu lheu uaq uaq
鏤形刮髓	镂形刮髓	鏤形刮髓	lheu yin kuaq shi
鏤耳朵	镂耳朵	鏤耳朵	lheu ng to
鏤耳朵	镂耳朵	鏤耳朵	lheu gni to
樓下	楼下	樓下	leu gho
樓房	楼房	樓房	leu vaon
樓屋	楼屋	樓屋	leu oq
樓登	楼登	樓登	leu ten
僂勾師	偻勾师	僂勾師	leu keu sy
漏字	漏字	漏字	leu zy
陋○吼○	陋○吼○	陋○吼○	leu heu
簍	篓	簍	leu4
走	走	走	tseu3
走之旁	走之旁	走之旁	tseu tsy baon
走氣	走气	走氣	tseu chi
走好	走好	走好	tseu hau
走馬燈	走马灯	走馬燈	tseu mo ten
走油肉	走油肉	走油肉	tseu yeu gnioq
走火	走火	走火	tseu hou
走走	走走	走走	tseu tseu
走陽	走阳	走陽	tseu yan
走廊	走廊	走廊	tseu laon
走江湖個	走江湖个	走江湖個	tseu kaon wu goq
走黄	走黄	走黃	tseu waon
走親眷	走亲眷	走親眷	tseu chin ciu
走人家	走人家	走人家	tseu gnin ko
走動	走动	走動	tseu don
走腳鈿	走脚钿	走腳鈿	tseu ciaq di
走出該	走出该	走出該	tseu tshyuq ke
皺皮打襇	皱皮打裥	皺皮打襉	tseu bi tan kae
湊	凑	湊	tsheu5
湊	凑	湊	tshei5
湊○	凑○	湊○	tsheu5
湊巧	凑巧	湊巧	tsheu chiau
湊隊家	凑队家	湊隊家	tsheu dei ko
湊頭	凑头	湊頭	tsheu deu
湊頭	凑头	湊頭	tsheu dei
湊隊	凑队	湊隊	tsheu dei
餿氣	馊气	餿氣	seu chi
毨	毨	毨	seu3
瘦	瘦	瘦	seu5
瘦骨材	瘦骨材	瘦骨材	seu kuaq ze
瘦怯怯	瘦怯怯	瘦怯怯	seu chiq chiq
瘦刮刮	瘦刮刮	瘦刮刮	seu kuaq kuaq
嗽	嗽	嗽	seu5
摗	摗	摗	seu5
愁	愁	愁	zeu2
愁頓頓	愁顿顿	愁頓頓	zeu ten ten
勾	勾	勾	keu1
狗皮倒竈	狗皮倒灶	狗皮倒竈	keu bi tau tsau
狗尾巴	狗尾巴	狗尾巴	keu mi po
狗爬式	狗爬式	狗爬式	keu bo shiq
狗窠	狗窠	狗窠	keu khou
狗筋懶斷	狗筋懒断	狗筋懶斷	keu cin lae doe
狗筋懶出	狗筋懒出	狗筋懶出	keu cin lae tshyuq
枸杞頭	枸杞头	枸杞頭	keu chi deu
口	口	口	kheu3
口番	口番	口番	kheu fae
口臭	口臭	口臭	kheu chieu
口頭	口头	口頭	kheu deu
口風	口风	口風	kheu fon
口供	口供	口供	kheu kon
扣好	扣好	扣好	kheu hau
扣扣	扣扣	扣扣	kheu kheu
扣分	扣分	扣分	kheu fen
扣刻	扣刻	扣刻	kheu khaq
𧥣	𧥣	𧥣	kheu5
𧺤	𧺤	𧺤	geu6
𧺤掉	𧺤掉	𧺤掉	geu diau
𧺤頭縮頸	𧺤头缩颈	𧺤頭縮頸	geu deu soq cin
牛	牛	牛	ngeu2
牛屄阿三	牛屄阿三	牛屄阿三	ngeu pi aq sae
牛鞭子	牛鞭子	牛鞭子	ngeu pi tsy
牛皮糖	牛皮糖	牛皮糖	ngeu bi daon
牛廐間	牛厩间	牛廄間	ngeu ji kae
牛肚	牛肚	牛肚	ngeu tu
牛草籃	牛草篮	牛草籃	ngeu tshau lae
牛車盤	牛车盘	牛車盤	ngeu tsho bun
牛坯	牛坯	牛坯	ngeu phei
牛頭	牛头	牛頭	ngeu deu
牛娘	牛娘	牛娘	ngeu gnian
牛虻	牛虻	牛虻	ngeu maon
牛筋	牛筋	牛筋	ngeu cin
牛繩	牛绳	牛繩	ngeu zhin
牛桊	牛桊	牛桊	ngeu ciun
牛鼻銷	牛鼻销	牛鼻銷	ngeu biq shiau
牛控䩉	牛控䩉	牛控䩉	ngeu khon bu
牛百葉	牛百叶	牛百葉	ngeu paq yiq
牛軛	牛轭	牛軛	ngeu aq
牛肉乾	牛肉干	牛肉乾	ngeu gnioq kI
偶湊	偶凑	偶湊	ngeu tsheu
藕	藕	藕	ngeu4
藕絲糖	藕丝糖	藕絲糖	ngeu sy daon
藕粉	藕粉	藕粉	ngeu fen
藕色	藕色	藕色	ngeu saq
☐	☐	☐	heu1
鱟	鲎	鱟	heu5
☐	☐	☐	heu5
喉結	喉结	喉結	gheu ciq
猴	猴	猴	gheu2
厚	厚	厚	gheu4
厚嘴厚得	厚嘴厚得	厚嘴厚得	gheu tsyu gheu taq
厚層層	厚层层	厚層層	gheu zen zen
厚粥	厚粥	厚粥	gheu tsoq
厚實	厚实	厚實	gheu zyuq
後司○頸	后司○颈	後司○頸	gheu sy cin
後司○頸做風水	后司○颈做风水	後司○頸做風水	gheu sy cin tsou fon syu
後屁股	后屁股	後屁股	gheu phi ku
後屁眼	后屁眼	後屁眼	gheu phi ngae
後天井	后天井	後天井	gheu thi cin
後年	后年	後年	gheu gni
後爹	后爹	後爹	gheu tia
後代	后代	後代	gheu de
後來	后来	後來	gheu le
後首來	后首来	後首來	gheu shieu le
後腳煞	后脚煞	後腳煞	gheu ciaq saq
後背	后背	後背	gheu pei
後頭	后头	後頭	gheu deu
後生	后生	後生	gheu san
後生家	后生家	後生家	gheu san ko
後梁頭	后梁头	後樑頭	gheu lian deu
後槍袋	后枪袋	後槍袋	gheu chian de
後娘	后娘	後孃	gheu gnian
後廂房	后厢房	後廂房	gheu shian vaon
後堂	后堂	後堂	gheu daon
後堂房	后堂房	後堂房	gheu daon vaon
後門	后门	後門	gheu men
後夾身	后夹身	後夾身	gheu kaq shin
後日子	后日子	後日子	gheu gniq tsy
候	候	候	gheu6
候眉刻毛	候眉刻毛	候眉刻毛	gheu mi khaq mau
候分刻毛	候分刻毛	候分刻毛	gheu fen khaq mau
候分刻數	候分刻数	候分刻數	gheu fen khaq su
候渠話話過	候渠话话过	候渠話話過	gheu ji wo wo kou
候我話話過	候我话话过	候我話話過	gheu ngo wo wo kou
候儂話話過	候侬话话过	候儂話話過	gheu nou wo wo kou
候人家話話過	候人家话话过	候人家話話過	gheu gnin ko wo wo kou
候自	候自	候自	gheu zhi
候隊	候队	候隊	gheu dei
候扣	候扣	候扣	gheu kheu
候分候數	候分候数	候分候數	gheu fen gheu su
候着	候着	候着	gheu zyuq
候着記把	候着记把	候着記把	gheu zyuq ci po
嘔	呕	嘔	eu1
嘔儂𢜭力𡀂	呕侬𢜭力𡀂	嘔儂𢜭力𡀂	eu nou jiaq liq lei
嘔俉𢜭力𡀂	呕俉𢜭力𡀂	嘔俉𢜭力𡀂	eu ng jiaq liq lei
要俉𢜭力𡀂	要俉𢜭力𡀂	要俉𢜭力𡀂	iau ng jiaq liq lei
傴倒	伛倒	傴倒	eu tau
傴頭磕腦	伛头磕脑	傴頭磕腦	eu deu khaq nau
綳	绷	繃	pan1
綳子	绷子	繃子	pan tsy
綳袋口	绷袋口	繃袋口	pan de kheu
綳場面	绷场面	繃場面	pan jian mi
綳門面	绷门面	繃門面	pan men mi
伯伯	伯伯	伯伯	pan pan
乓○	乓○	乓○	phan1
乓○剖○	乓○剖○	乓○剖○	phan phou
碰和臺	碰和台	碰和臺	phan wu de
碰杯	碰杯	碰杯	phan pei
朋○	朋○	朋○	ban2
朋友	朋友	朋友	ban yeu
朋友道裏	朋友道里	朋友道裏	ban yeu dau li
朋友家	朋友家	朋友家	ban yeu ko
彭祖暴	彭祖暴	彭祖暴	ban tsu pau
彭彭揚	彭彭扬	彭彭揚	ban ban yan
棚車	棚车	棚車	ban tsho
棚梯	棚梯	棚梯	ban the
碰㬹	碰㬹	碰㬹	ban tsan
碰着	碰着	碰着	ban zyuq
碰着	碰着	碰着	phon zyuq
甏	甏	甏	ban6
甏腳	甏脚	甏腳	ban ciaq
蟛蟲	蟛虫	蟛蟲	ban dzon
☐☐	☐☐	☐☐	mhan mhan
猛	猛	猛	man4
猛日頭	猛日头	猛日頭	man gniq deu
打	打	打	tan3
打水機船	打水机船	打水機船	tan syu ci zOE
打水陸	打水陆	打水陸	tan syu loq
打勢	打势	打勢	tan syu
打屁股	打屁股	打屁股	tan phi ku
打眠鼾	打眠鼾	打眠鼾	tan mi he
打底	打底	打底	tan ti
打地鋪	打地铺	打地鋪	tan di phu
打蓮花朗	打莲花朗	打蓮花朗	tan li huo laon
打蓮花落	打莲花落	打蓮花落	tan li huo laon
打虎跳	打虎跳	打虎跳	tan fu thiau
打派司	打派司	打派司	tan pha sy
打撲克	打扑克	打撲克	tan phoq khaq
打杜勒克	打杜勒克	打杜勒克	tan du laq khaq
打老K	打老K	打老K	tan lau khe
打牌九	打牌九	打牌九	tan ba cieu
打寶	打宝	打寶	tan pau
打稻	打稻	打稻	tan dau
打稻機	打稻机	打稻機	tan dau ci
打草稿	打草稿	打草稿	tan tshau kau
打霸勢	打霸势	打霸勢	tan po syu
打交	打交	打交	tan ciau
打醮	打醮	打醮	tan ciau
打照面	打照面	打照面	tan ciau mi
打腰鼓	打腰鼓	打腰鼓	tan iau ku
打花㪝槌	打花㪝槌	打花㪝槌	tan huo li dzyu
打呵酣	打呵酣	打呵酣	tan huo he
打胎	打胎	打胎	tan the
打䬵	打䬵	打䬵	tan ge
打板子	打板子	打板子	tan pae tsy
打扮	打扮	打扮	tan pae
打彈子	打弹子	打彈子	tan dae tsy
打揫	打揫	打揫	tan chieu
打泅	打泅	打泅	tan jieu
打手天心	打手天心	打手天心	tan shieu thi shin
打手銃	打手铳	打手銃	tan shieu tshon
打短	打短	打短	tan toe
打亂草	打乱草	打亂草	tan loe tshau
打探動鼓	打探动鼓	打探動鼓	tan thei don ku
打回	打回	打回	tan wei
打火石	打火石	打火石	tan hou zaq
打𧺤泥	打𧺤泥	打𧺤泥	tan geu gni
打後手	打后手	打後手	tan gheu shieu
打朋	打朋	打朋	tan ban
打冷呃	打冷呃	打冷呃	tan lan aq
打長	打长	打長	tan jian
打相打	打相打	打相打	tan shian tan
打烊	打烊	打烊	tan yan
打☐	打☐	打☐	tan huan
打横	打横	打橫	tan wan
打掌子	打掌子	打掌子	tan tsaon tsy
打官司	打官司	打官司	tan kun sy
打併	打并	打併	tan phin
打銀針	打银针	打銀針	tan gnin cin
打渾	打浑	打渾	tan wen
打凍	打冻	打凍	tan ton
打中覺	打中觉	打中覺	tan tson kau
打迾軋	打迾轧	打迾軋	tan laq gaq
打殺坯	打杀坯	打殺坯	tan saq phei
打勿殺	打勿杀	打勿殺	tan vaq saq
打瞌𥅻	打瞌𥅻	打瞌𥅻	tan khaq tshon
打腳骨軟	打脚骨软	打腳骨軟	tan ciaq kuaq gniu
打滑躂	打滑跶	打滑躂	tan waq daq
打滑脫	打滑脱	打滑脫	tan waq thaq
打鐵師父	打铁师父	打鐵師父	tan thiq sy vu
打結	打结	打結	tan ciq
打錫箔個	打锡箔个	打錫箔個	tan shiq boq goq
打噎	打噎	打噎	tan iq
☐鑼	☐锣	☐鑼	than lou
軋出☐鑼	轧出☐锣	軋出☐鑼	gaq tshyuq than lou
趤	趤	趤	dan6
趤馬路	趤马路	趤馬路	dan mo lu
趤街	趤街	趤街	dan ka
趤亨	趤亨	趤亨	dan han
宕	宕	宕	dan6
宕賬	宕账	宕賬	dan cian
宕長	宕长	宕長	dan jian
☐☐	☐☐	☐☐	lan lan
冷	冷	冷	lan4
冷○士	冷○士	冷○士	lan zy
冷○士嬸	冷○士婶	冷○士嬸	lan zy shin
冷水	冷水	冷水	lan syu
冷势勢	冷势势	冷勢勢	lan syu syu
冷麵	冷面	冷麪	lan mi
冷天價	冷天价	冷天價	lan thi ko
冷氣肉	冷气肉	冷氣肉	lan chi gnioq
冷茶	冷茶	冷茶	lan dzo
冷開水	冷开水	冷開水	lan khe syu
冷茶壺	冷茶壶	冷茶壺	lan dzo wu
冷水壺	冷水壶	冷水壺	lan syu wu
冷痧	冷痧	冷痧	lan so
冷板凳	冷板凳	冷板凳	lan pae ten
冷飯塊	冷饭块	冷飯塊	lan vae khuei
冷飯得	冷饭得	冷飯得	lan vae taq
冷飯頭	冷饭头	冷飯頭	lan vae deu
冷飯	冷饭	冷飯	lan vae
冷飯𥽬	冷饭𥽬	冷飯𥽬	lan vae gnian
冷幽幽	冷幽幽	冷幽幽	lan ieu ieu
冷灰頭爆	冷灰头爆	冷灰頭爆	lan huei deu pau
冷黄梅	冷黄梅	冷黃梅	lan waon mei
冷黄霉	冷黄霉	冷黃黴	lan waon mei
冷盆	冷盆	冷盆	lan ben
冷冰冰	冷冰冰	冷冰冰	lan pin pin
冷凊凊	冷凊凊	冷凊凊	lan chin chin
冷𪞫𪞫	冷𪞫𪞫	冷𪞫𪞫	lan seu seu
冷靜	冷静	冷靜	lan zhin
冷蔭	冷荫	冷蔭	lan in
冷凍凍	冷冻冻	冷凍凍	lan ton ton
冷刮刮	冷刮刮	冷刮刮	lan kuaq kuaq
冷落	冷落	冷落	lan loq
冷角落頭	冷角落头	冷角落頭	lan koq loq deu
爭	争	爭	tsan1
掙株	挣株	掙株	tsan tsyu
掙家計	挣家计	掙家計	tsan ko ci
撑	撑	撐	tshan1
撑市面	撑市面	撐市面	tshan zy mi
撑門面	撑门面	撐門面	tshan men mi
撑腰	撑腰	撐腰	tshan iau
撑鬥風船	撑斗风船	撐鬥風船	tshan teu fon zOE
撑擋	撑挡	撐擋	tshan taon
撑鈴	撑铃	撐鈴	tshan lin
撑腳	撑脚	撐腳	tshan ciaq
䂻	䂻	䂻	dzan6
䂻渠肚裏勿得	䂻渠肚里勿得	䂻渠肚裏勿得	dzan ji du li vaq taq
䂻儂肚裏勿得	䂻侬肚里勿得	䂻儂肚裏勿得	dzan nou du li vaq taq
䂻俉肚裏勿得	䂻俉肚里勿得	䂻俉肚裏勿得	dzan ng du li vaq taq
䂻笆洞	䂻笆洞	䂻笆洞	dzan po don
鋥亮	锃亮	鋥亮	dzan lian
鋥鋥亮	锃锃亮	鋥鋥亮	dzan dzan lian
鋥刮斯亮	锃刮斯亮	鋥刮斯亮	dzan kuaq sy lian
瞠	瞠	瞠	dzan6
生	生	生	san1
生煸	生煸	生煸	san pi
生地	生地	生地	san di
生煎	生煎	生煎	san ci
生煎餃子	生煎饺子	生煎餃子	san ci ciau tsy
生意	生意	生意	san i
生意幫	生意帮	生意幫	san i paon
生意經	生意经	生意經	san i cin
生意人	生意人	生意人	san i gnin
生爐子	生炉子	生爐子	san lu tsy
發爐子	发炉子	發爐子	faq lu tsy
生小人	生小人	生小人	san shiau gnin
生菜	生菜	生菜	san tshe
生晚青	生晚青	生晚青	san mae chin
生晚稻	生晚稻	生晚稻	san mae dau
生夜稻	生夜稻	生夜稻	san ya dau
生蛋	生蛋	生蛋	san dae
生蛋鷄	生蛋鸡	生蛋雞	san dae ci
生鹹	生咸	生鹹	san ghae
生苦鐵鹹	生苦铁咸	生苦鐵鹹	san khu thiq ghae
生手	生手	生手	san shieu
生油氣	生油气	生油氣	san yeu chi
生頭	生头	生頭	san deu
生頭人	生头人	生頭人	san deu gnin
生頭人客	生头人客	生頭人客	san deu gnin khaq
生頭陌腳	生头陌脚	生頭陌腳	san deu maq ciaq
生冷	生冷	生冷	san lan
生冷東西	生冷东西	生冷東西	san lan ton shi
生薑	生姜	生薑	san cian
生癢	生痒	生癢	san yan
生病黄魚	生病黄鱼	生病黃魚	san bin waon ng
生病人	生病人	生病人	san bin gnin
生疔瘡	生疔疮	生疔瘡	san tin tshaon
生膿	生脓	生膿	san non
生葱氣	生葱气	生蔥氣	san tshon chi
生辣	生辣	生辣	san laq
生生辣辣	生生辣辣	生生辣辣	san san laq laq
生隔壁氣	生隔壁气	生隔壁氣	san kaq piq chi
生活	生活	生活	san waq
生鐵	生铁	生鐵	san thiq
生鐵補镬	生铁补镬	生鐵補鑊	san thiq pu ghoq
生日	生日	生日	san gniq
生日酒	生日酒	生日酒	san gniq cieu
生姆羹	生姆羹	生姆羹	san m kan
生姆娘	生姆娘	生姆孃	san m gnian
生姆月裏	生姆月里	生姆月裏	san m yuq li
省省	省省	省省	san san
省省嗇嗇	省省啬啬	省省嗇嗇	san san saq saq
省勒	省勒	省勒	san laq
省力	省力	省力	san liq
𤯡	𤯡	𤯡	san5
庚	庚	庚	kan1
耕地	耕地	耕地	kan di
粳米	粳米	粳米	kan mi
羹架	羹架	羹架	kan ko
羹調	羹调	羹調	kan diau
羹飯	羹饭	羹飯	kan vae
羹桶	羹桶	羹桶	kan don
梗	梗	梗	kan5
坑頭	坑头	坑頭	khan deu
坑頭間	坑头间	坑頭間	khan deu kae
坑跟間	坑跟间	坑跟間	khan ken kae
鯁胡嚨	鲠胡咙	鯁胡嚨	gan wu lon
鯁牢	鲠牢	鯁牢	gan lau
硬	硬	硬	ngan6
硬至○至○	硬至○至○	硬至○至○	ngan tsy tsy
硬柴	硬柴	硬柴	ngan za
硬燥燥	硬燥燥	硬燥燥	ngan sau sau
硬拗𢺵	硬拗𢺵	硬拗𢺵	ngan au ji
硬絞𢺵	硬绞𢺵	硬絞𢺵	ngan gau ji
硬照	硬照	硬照	ngan ciau
硬板牀	硬板床	硬板牀	ngan pae zaon
硬綳綳	硬绷绷	硬繃繃	ngan pan pan
硬碰硬	硬碰硬	硬碰硬	ngan phan ngan
硬撑	硬撑	硬撐	ngan tshan
硬糖	硬糖	硬糖	ngan daon
硬傷	硬伤	硬傷	ngan saon
硬上	硬上	硬上	ngan zaon
硬黄○	硬黄○	硬黃○	ngan waon
硬襯	硬衬	硬襯	ngan tshen
硬竟	硬竟	硬竟	ngan cin
硬襞紙	硬襞纸	硬襞紙	ngan paq tsy
硬蠟○	硬蜡○	硬蠟○	ngan laq
硬扎○	硬扎○	硬扎○	ngan tsaq
硬骨粒	硬骨粒	硬骨粒	ngan kuaq liq
硬剝剝	硬剥剥	硬剝剝	ngan poq poq
硬的剝落	硬的剥落	硬的剝落	ngan tiq poq loq
硬結結	硬结结	硬結結	ngan ciq ciq
硬結刮剌	硬结刮剌	硬結刮剌	ngan ciq kuaq laq
亨○麥○冷○打○	亨○麦○冷○打○	亨○麥○冷○打○	han maq lan tan
亨○白○冷○打○	亨○白○冷○打○	亨○白○冷○打○	han baq lan tan
亨○麥○冷○	亨○麦○冷○	亨○麥○冷○	han maq lan
亨○白○冷○	亨○白○冷○	亨○白○冷○	han baq lan
行	行	行	ghan2
行鞭笋	行鞭笋	行鞭筍	ghan pi syun
行李	行李	行李	ghan li
行廟會	行庙会	行廟會	ghan miau wei
行爲	行为	行爲	ghan wei
行會	行会	行會	ghan wei
行頭	行头	行頭	ghan deu
行人勢	行人势	行人勢	ghan gnin syu
行得春風有夏雨	行得春风有夏雨	行得春風有夏雨	ghan taq tshyun fon yeu gho yu
桁條	桁条	桁條	ghan diau
杏子	杏子	杏子	ghan tsy
杏花	杏花	杏花	ghan huo
杏仁	杏仁	杏仁	ghan gnin
阿姆	阿姆	阿姆	an m
櫻桃	樱桃	櫻桃	an dau
鹦哥	鹦哥	鸚哥	an kou
㹙	㹙	㹙	an3
揞	揞	揞	an5
揞	揞	揞	khan5
揞水片	揞水片	揞水片	an syu phi
揞水片	揞水片	揞水片	khan syu phi
揞掉	揞掉	揞掉	an diau
揞掉	揞掉	揞掉	khan diau
良心	良心	良心	lian shin
涼帽篷	凉帽篷	涼帽篷	lian mau bon
涼蓬	凉蓬	涼蓬	lian bon
涼牀	凉床	涼牀	lian zaon
三彎涼牀	三弯凉床	三彎涼牀	sae uae lian zaon
七彎涼牀	七弯凉床	七彎涼牀	chiq uae lian zaon
梁山伯廟	梁山伯庙	梁山伯廟	lian sae paq miau
量衣裳	量衣裳	量衣裳	lian i zaon
糧食	粮食	糧食	lian zhiq
兩	两	兩	lian4
兩點水	两点水	兩點水	lian ti syu
兩鈿	两钿	兩鈿	lian di
兩連襟	两连襟	兩連襟	lian li cin
兩姊妹	两姊妹	兩姊妹	lian ci mei
兩夫妻	两夫妻	兩夫妻	lian fu chi
兩姑嫂	两姑嫂	兩姑嫂	lian ku sau
兩爹	两爹	兩爹	lian tia
兩老	两老	兩老	lian lau
兩老頭	两老头	兩老頭	lian lau deu
兩公婆	两公婆	兩公婆	lian kon bou
兩瓜○生	两瓜○生	兩瓜○生	lian ko san
兩家婆	两家婆	兩家婆	lian ko bou
兩眼竈	两眼灶	兩眼竈	lian ngae tsau
兩娘	两娘	兩娘	lian gnian
兩樣生	两样生	兩樣生	lian yan san
兩樣	两样	兩樣	lian yan
兩親家公	两亲家公	兩親家公	lian chin ko kon
兩親家姆	两亲家姆	兩親家姆	lian chin ko m
兩兄弟	两兄弟	兩兄弟	lian shion di
兩百五十	两百五十	兩百五十	lian paq ng zyuq
兩百一	两百一	兩百一	lian paq iq
兩百二	两百二	兩百二	lian paq gni
兩百兩	两百两	兩百兩	lian paq lian
兩百三	两百三	兩百三	lian paq sae
兩百四	两百四	兩百四	lian paq sy
兩百五	两百五	兩百五	lian paq ng
兩百六	两百六	兩百六	lian paq loq
兩百七	两百七	兩百七	lian paq chiq
兩百八	两百八	兩百八	lian paq paq
兩百九	两百九	兩百九	lian paq cieu
兩隻手絞仔	两只手绞仔	兩隻手絞仔	lian tsaq shieu gau tsy
兩隔生	两隔生	兩隔生	lian kaq san
兩腳路梯	两脚路梯	兩腳路梯	lian ciaq lu the
兩叔伯姆	两叔伯姆	兩叔伯姆	lian soq pan m
兩妯娌	两妯娌	兩妯娌	lian dzoq li
兩個	两个	兩個	lian goq
兩個	两个	兩個	lian kou
兩結結	两结结	兩結結	lian ciq ciq
亮	亮	亮	lian6
亮吹熓	亮吹𤆡	亮吹熓	lian tshyu u
亮眼	亮眼	亮眼	lian ngae
亮眼𥳖	亮眼𥳖	亮眼𥳖	lian ngae bu
亮眼路梯	亮眼路梯	亮眼路梯	lian ngae lu the
亮眼頭絲	亮眼头丝	亮眼頭絲	lian ngae deu sy
亮眼瞎子	亮眼瞎子	亮眼瞎子	lian ngae haq tsy
亮穿穿	亮穿穿	亮穿穿	lian tshOE tshOE
亮頭	亮头	亮頭	lian deu
亮頭裏	亮头里	亮頭裏	lian deu li
亮槅	亮槅	亮槅	lian kaq
亮潔	亮洁	亮潔	lian ciq
將	将	將	cian1
將面聾	将面聋	將面聾	cian mi lon
借米聾	借米聋	借米聾	cia mi lon
將補	将补	將補	cian pu
將就	将就	將就	cian jieu
將煞𡀂	将煞𡀂	將煞𡀂	cian saq lei
張	张	張	cian1
张記望記	张记望记	張記望記	cian ci uaon ci
張猫	张猫	張貓	cian mau
僵	僵	僵	cian1
僵脯飯	僵脯饭	僵脯飯	cian bu vae
僵個	僵个	僵個	cian kou
僵個佬	僵个佬	僵個佬	cian kou lau
僵個貓○	僵个猫○	僵個貓○	cian kou mae
僵硬	僵硬	僵硬	cian ngan
僵硬骨粒	僵硬骨粒	僵硬骨粒	cian ngan kuaq liq
漿	浆	漿	cian1
漿水	浆水	漿水	cian syu
漿糊	浆糊	漿糊	cian wu
漿板	浆板	漿板	cian pae
薑	姜	姜	cian1
漲潮	涨潮	漲潮	cian jiau
漲息	涨息	漲息	cian shiq
槳	桨	槳	cian3
槳圈	桨圈	槳圈	cian chiu
槳柄	桨柄	槳柄	cian pin
槳葉	桨叶	槳葉	cian yiq
帳子	帐子	帳子	cian tsy
帳子㫰竿	帐子㫰竿	帳子㫰竿	cian tsy laon kI
帳衣	帐衣	帳衣	cian i
帳頭人案	帐头人案	帳頭人案	cian deu gnin e
帳鈎	帐钩	帳鉤	cian keu
帳門	帐门	帳門	cian men
帳頂	帐顶	帳頂	cian tin
帳○箜	帐○箜	帳○箜	cian khon
帳○箜籃	帐○箜篮	帳○箜籃	cian khon lae
賬房	账房	賬房	cian vaon
賬房先生	账房先生	賬房先生	cian vaon shi san
脹	胀	脹	cian5
脹面癗	胀面癗	脹面癗	cian mi lei
脹話	胀话	脹話	cian wo
脹膯	胀膯	脹膯	cian ten
脹拔拔	胀拔拔	脹拔拔	cian baq baq
脹鼓鼓	胀鼓鼓	脹鼓鼓	cian ku ku
脹煞𡀂	胀煞𡀂	脹煞𡀂	cian saq lei
醬園	酱园	醬園	cian yu
醬菜	酱菜	醬菜	cian tshe
醬油	酱油	醬油	cian yeu
醬油瓜子	酱油瓜子	醬油瓜子	cian yeu kuo tsy
醬丁	酱丁	醬丁	cian tin
醬貨店	酱货店	醬貨店	cian hou ti
醬豆腐	酱豆腐	醬豆腐	cian deu vu
醬肉	酱肉	醬肉	cian gnioq
羌○	羌○	羌○	chian1
羌餅	羌饼	羌餅	chian pin
腔	腔	腔	chian1
槍○	枪○	槍○	chian1
槍斃鬼	枪毙鬼	槍斃鬼	chian bi ciu
槍笆	枪笆	槍笆	chian po
搶	抢	搶	chian3
搶犯	抢犯	搶犯	chian vae
搶窠幽貓	抢窠幽猫	搶窠幽貓	chian khou ieu mae
搶親	抢亲	搶親	chian chin
嗆	呛	嗆	chian5
嗆○	呛○	嗆○	chian5
嗆○氣	呛○气	嗆○氣	chian chi
嗆○拍	呛○拍	嗆○拍	chian phaq
𪉨蟹	𪉨蟹	𪉨蟹	chian ha
𪉨蝦	𪉨虾	𪉨蝦	chian huo
長	长	長	jian2
長麵	长面	長麪	jian mi
長臍	长脐	長臍	jian ji
長年	长年	長年	jian gni
長工	长工	長工	jian kon
長年到頭	长年到头	長年到頭	jian gni tau deu
長股短	长股短	長股短	jian ku toe
長遠	长远	長遠	jian yu
長矮凳	长矮凳	長矮凳	jian a ten
長凳	长凳	長凳	jian ten
長丫臉	长丫脸	長丫臉	jian o li
長條桌	长条桌	長條桌	jian diau tsoq
長𢿞𢿞	长𢿞𢿞	長𢿞𢿞	jian liau liau
長𢿞條	长𢿞条	長𢿞條	jian liau diau
長衫	长衫	長衫	jian sae
長壽麵	长寿面	長壽麪	jian zhieu mi
壽麵	寿面	壽麪	zhieu mi
長大	长大	長大	jian dou
長長大大	长长大大	長長大大	jian jian dou dou
長鱟	长鲎	長鱟	jian heu
長孟孟	长孟孟	長孟孟	jian man man
長常	长常	長常	jian dzaon
長時	长时	長時	jian zy
長豇豆	长豇豆	長豇豆	jian kaon deu
長生果	长生果	長生果	jian sen kou
長統襪	长统袜	長統襪	jian thon maq
長白燈籠	长白灯笼	長白燈籠	jian baq ten lon
長襪	长袜	長襪	jian maq
長腳鷺鷥	长脚鹭鸶	長腳鷺鷥	jian ciaq lu sy
場	场	場	jian2
强	强	強	jian2
强討飯	强讨饭	強討飯	jian thau vae
强盜	强盗	強盜	jian dau
强盜坯	强盗坯	強盜坯	jian dau phei
强横	强横	強橫	jian uan
强横霸道	强横霸道	強橫霸道	jian uan po dau
腸	肠	腸	jian2
薔薇	蔷薇	薔薇	jian vi
丈板	丈板	丈板	jian pae
丈人老頭	丈人老头	丈人老頭	jian gnin lau deu
丈人阿伯	丈人阿伯	丈人阿伯	jian gnin aq paq
丈人	丈人	丈人	jian gnin
丈姆家	丈姆家	丈姆家	jian m ko
丈姆娘	丈姆娘	丈姆孃	jian m gnian
丈姆	丈姆	丈姆	jian m
仗人勢	仗人势	仗人勢	jian gnin syu
⿰氵丈	⿰氵丈	⿰氵丈	jian4
⿰氵丈面	⿰氵丈面	⿰氵丈面	jian mi
⿰氵丈面水	⿰氵丈面水	⿰氵丈面水	jian mi syu
⿰氵丈衣裳	⿰氵丈衣裳	⿰氵丈衣裳	jian i zaon
⿰氵丈手	⿰氵丈手	⿰氵丈手	jian shieu
⿰氵丈頭	⿰氵丈头	⿰氵丈頭	jian deu
⿰氵丈人	⿰氵丈人	⿰氵丈人	jian gnin
⿰氵丈肉	⿰氵丈肉	⿰氵丈肉	jian gnioq
⿰氵丈人腳桶	⿰氵丈人脚桶	⿰氵丈人腳桶	jian gnin ciaq don
⿰氵丈腳水	⿰氵丈脚水	⿰氵丈腳水	jian ciaq syu
⿰氵丈腳布	⿰氵丈脚布	⿰氵丈腳布	jian ciaq pu
⿰氵丈肉間	⿰氵丈肉间	⿰氵丈肉間	jian gnioq kae
⿰氵丈一水	⿰氵丈一水	⿰氵丈一水	jian iq syu
弶	弶	弶	jian6
象山鷄	象山鸡	象山雞	jian sae ci
犟頭倔腦	犟头倔脑	犟頭倔腦	jian deu jiuq nau
犟頭犟腦	犟头犟脑	犟頭犟腦	jian deu jian nau
☐烏貓	☐乌猫	☐烏貓	knian u mae
娘	娘	孃	gnian2
娘子	娘子	娘子	gnian tsy
娘子阿姆	娘子阿姆	娘子阿姆	gnian tsy an m
娘姨	娘姨	孃姨	gnian yi
娘家	娘家	孃家	gnian ko
娘舅	娘舅	孃舅	gnian jieu
娘舅外甥	娘舅外甥	孃舅外甥	gnian jieu nga san
娘戳屄	娘戳屄	娘戳屄	gnian tshoq pi
仰死仰倒	仰死仰倒	仰死仰倒	gnian shi gnian tau
相	相	相	shian1
相思樹	相思树	相思樹	shian sy zyu
相干	相干	相干	shian kI
相好	相好	相好	shian hau
相煩	相烦	相煩	shian vae
相量盞	相量盏	相量盞	shian lian tsae
相幫	相帮	相幫	shian paon
相親	相亲	相親	shian chin
相信	相信	相信	shian shin
香	香	香	shian1
香屍蟲	香尸虫	香屍蟲	shian sy dzon
香水	香水	香水	shian syu
香肥皂	香肥皂	香肥皂	shian bi zau
香妃色	香妃色	香妃色	shian fi saq
香榧子	香榧子	香榧子	shian fi tsy
香乾	香干	香乾	shian kI
香煙	香烟	香菸	shian i
香煙屁股	香烟屁股	香菸屁股	shian i phi ku
香煙蒂頭	香烟蒂头	香菸蒂頭	shian i ti deu
香煙牌子	香烟牌子	香菸牌子	shian i ba tsy
香煙殼子	香烟壳子	香菸殼子	shian i khoq tsy
香爐	香炉	香爐	shian lu
香酥餅	香酥饼	香酥餅	shian su pin
香萵笋	香莴笋	香萵筍	shian u syun
萵苣笋	莴苣笋	萵苣筍	u jiu syun
香泡	香泡	香泡	shian phau
香瓜	香瓜	香瓜	shian kuo
香瓜子	香瓜子	香瓜子	shian kuo tsy
香菜	香菜	香菜	shian tshe
香揀芋	香拣芋	香揀芋	shian ke gniu
香脆餅	香脆饼	香脆餅	shian tshei pin
香灰	香灰	香灰	shian huei
香涼蟲	香凉虫	香涼蟲	shian lian dzon
香腸	香肠	香腸	shian jian
香蕈	香蕈	香蕈	shian jin
香椿樹	香椿树	香椿樹	shian tshyun zyu
香烘烘	香烘烘	香烘烘	shian hon hon
香客	香客	香客	shian khaq
鄉裏	乡里	鄉里	shian li
鄉下	乡下	鄉下	shian gho
鄉下頭	乡下头	鄉下頭	shian gho deu
鄉下人	乡下人	鄉下人	shian gho gnin
廂房	厢房	廂房	shian vaon
箱子	箱子	箱子	shian tsy
箱子間	箱子间	箱子間	shian tsy kae
鑲盆	镶盆	鑲盆	shian ben
鮝	鲞	鯗	shian3
鮝𥳖	鲞𥳖	鯗𥳖	shian bu
響箱	响箱	響箱	shian shian
響米花	响米花	響米花	shian mi huo
響雷	响雷	響雷	shian lei
向	向	向	shian5
向天泅	向天泅	向天泅	shian thi jieu
向天睏	向天困	向天睏	shian thi khuen
向白藍	向白蓝	向白藍	shian baq lae
向日葵	向日葵	向日葵	shian zyuq guei
相	相	相	shian1
相勢	相势	相勢	shian syu
相仙	相仙	相仙	shian shi
相拋天	相抛天	相拋天	shian phau thi
相天	相天	相天	shian thi
相貌	相貌	相貌	shian mau
相因	相因	相因	shian in
牆基	墙基	牆基	zhian ci
牆外頭	墙外头	牆外頭	zhian nga deu
牆門	墙门	牆門	zhian men
牆腳	墙脚	牆腳	zhian ciaq
牆角落頭	墙角落头	牆角落頭	zhian koq loq deu
牆壁	墙壁	牆壁	zhian piq
牆壁裏	墙壁里	牆壁裏	zhian piq li
象	象	象	zhian4
象棋	象棋	象棋	zhian ji
像人家	像人家	像人家	zhian gnin ko
像煞	像煞	像煞	zhian saq
像煞有介事	像煞有介事	像煞有介事	zhian saq yeu ka zy
橡皮	橡皮	橡皮	zhian bi
橡皮魚	橡皮鱼	橡皮魚	zhian bi ng
羊	羊	羊	yan2
羊尾笋	羊尾笋	羊尾筍	yan vi syun
羊癲風	羊癫风	羊癲風	yan ti fon
羊癲病	羊癫病	羊癲病	yan ti bin
羊角	羊角	羊角	yan koq
洋皮皮	洋皮皮	洋皮皮	yan bi bi
洋鈿	洋钿	洋鈿	yan di
洋錢餅	洋钱饼	洋錢餅	yan ji pin
洋籼米	洋籼米	洋秈米	yan shi mi
洋油	洋油	洋油	yan yeu
洋娃娃	洋娃娃	洋娃娃	yan ua ua
洋囡囡	洋囡囡	洋囡囡	yan noe noe
洋泡泡	洋泡泡	洋泡泡	yan phau phau
洋抄簿	洋抄簿	洋抄簿	yan tshau bu
洋銬	洋铐	洋銬	yan khau
808	808	808	paq lin paq
洋車	洋车	洋車	yan tsho
洋紗團心子	洋纱团心子	洋紗團心子	yan so doe shin tsy
洋瓦	洋瓦	洋瓦	yan ngo
洋鉛皮	洋铅皮	洋鉛皮	yan khae bi
洋鉛面桶	洋铅面桶	洋鉛面桶	yan khae mi don
洋火	洋火	洋火	yan hou
洋生薑	洋生姜	洋生薑	yan san cian
洋房	洋房	洋房	yan vaon
洋裝	洋装	洋裝	yan tsaon
洋行	洋行	洋行	yan ghaon
洋盤	洋盘	洋盤	yan bun
洋粉袋	洋粉袋	洋粉袋	yan fen de
洋釘	洋钉	洋釘	yan tin
洋葱頭	洋葱头	洋蔥頭	yan tshon deu
洋辣毛	洋辣毛	洋辣毛	yan laq mau
洋蠟燭	洋蜡烛	洋蠟燭	yan laq tsoq
洋燭	洋烛	洋燭	yan tsoq
洋芋艿	洋芋艿	洋芋艿	yan n na
洋番薯	洋番薯	洋番薯	yan fae zyu
陽帽篷	阳帽篷	陽帽篷	yan mau bon
陽珓	阳珓	陽珓	yan kau
陽臺	阳台	陽臺	yan de
陽傘	阳伞	陽傘	yan sae
陽文	阳文	陽文	yan ven
陽春麵	阳春面	陽春麪	yan tshyun mi
揚麥	扬麦	揚麥	yan maq
揚穀	扬谷	揚穀	yan koq
楊樹	杨树	楊樹	yan zyu
楊花	杨花	楊花	yan huo
楊柳腰	杨柳腰	楊柳腰	yan lieu iau
楊梅	杨梅	楊梅	yan mei
楊梅時	杨梅时	楊梅時	yan mei zy
楊梅汛裏	杨梅汛里	楊梅汛裏	yan mei shin li
楊梅乾	杨梅干	楊梅乾	yan mei kI
楊梅瘡	杨梅疮	楊梅瘡	yan mei tshaon
煬	炀	煬	yan6
煬勩	炀勚	煬勩	yan yi
養生新婦	养生新妇	養生新婦	yan san shin vu
養生	养生	養生	yan san
瀁瀁動	瀁瀁动	瀁瀁動	yan yan don
樣	样	樣	yan6
樣子	样子	樣子	yan tsy
樣範	样范	樣範	yan vae
樣有份	样有份	樣有份	yan yeu ven
癢颼颼	痒飕飕	癢颼颼	yan seu seu
癢木樓颼	痒木楼飕	癢木樓颼	yan moq leu seu
陽溝	阳沟	陽溝	ian keu
秧子	秧子	秧子	ian tsy
秧子穀	秧子谷	秧子穀	ian tsy koq
秧子出田	秧子出田	秧子出田	ian tsy tshyuq di
秧田	秧田	秧田	ian di
秧苗	秧苗	秧苗	ian miau
秧	秧	秧	ian1
養	养	養	ian3
養嬌	养娇	養嬌	ian ciau
養囡	养囡	養囡	ian noe
養瘦馬	养瘦马	養瘦馬	ian seu mo
養娘	养娘	養孃	ian gnian
養出	养出	養出	ian tshyuq
養兒子	养儿子	養兒子	ian ng tsy
挭	挭	挭	kuan1
梗	梗	梗	kuan3
梗子	梗子	梗子	kuan tsy
光○酸	光○酸	光○酸	kuan soe
光○得斯酸	光○得斯酸	光○得斯酸	kuan taq sy soe
光火	光火	光火	kuan hou
光○青	光○青	光○青	kuan chin
☐☐奔	☐☐奔	☐☐奔	guan guan pen
☐☐追	☐☐追	☐☐追	guan guan tsei
☐☐逃	☐☐逃	☐☐逃	guan guan dau
☐	☐	☐	huan5
横竪	横竖	橫豎	wan zyu
横竪	横竖	橫豎	wan zyu
横使	横使	橫使	wan sy
横縱	横纵	橫縱	wan tson
横豎横	横竖横	橫豎橫	wan zyu wan
横裏	横里	橫裏	wan li
横横動	横横动	橫橫動	wan wan don
横蕭	横萧	橫蕭	wan shiau
横愛司頭	横爱司头	橫愛司頭	wan e sy deu
横頭	横头	橫頭	wan deu
横梁	横梁	橫樑	wan lian
横	横	橫	wan6
横○賭	横○赌	橫○賭	wan tu
横○	横○	橫○	wan6
横○東道	横○东道	橫○東道	wan ton dau
横至○至○	横至○至○	橫至○至○	uan tsy tsy
横𠡒	横𠡒	橫𠡒	uan tei
幫頭	帮头	幫頭	paon deu
幫襯	帮衬	幫襯	paon tshen
綁票	绑票	綁票	paon phiau
磅秤	磅秤	磅秤	paon chin
胖起	胖起	胖起	phaon chi
胖脯	胖脯	胖脯	phaon bu
胖乎乎	胖乎乎	胖乎乎	phaon fu fu
胖頭魚	胖头鱼	胖頭魚	phaon deu ng
胖陽𣝗	胖阳𣝗	胖陽𣝗	phaon yan waq
胖墩墩	胖墩墩	胖墩墩	phaon ten ten
髈蹄	髈蹄	髈蹄	phaon di
防	防	防	baon2
防來	防来	防來	baon le
旁邊頭	旁边头	旁邊頭	baon pi deu
旁邊	旁边	旁邊	baon pi
螃元蟹	螃元蟹	螃元蟹	baon gniu ha
棒冰	棒冰	棒冰	baon pin
傍早	傍早	傍早	baon tsau
芒種	芒种	芒種	maon tson
忙	忙	忙	maon2
忙月	忙月	忙月	maon yuq
盲腸	盲肠	盲腸	maon jian
盲腸炎	盲肠炎	盲腸炎	maon jian yi
忘記太公	忘记太公	忘記太公	maon ci tha kon
忘伯伯	忘伯伯	忘伯伯	maon paq paq
望	望	望	maon6
望遠鏡	望远镜	望遠鏡	maon yu cin
望潮	望潮	望潮	maon jiau
望娘盤	望娘盘	望娘盤	maon gnian bun
網	网	網	maon4
網綫袋	网线袋	網線袋	maon shi de
網油	网油	網油	maon yeu
方矮凳	方矮凳	方矮凳	faon a ten
方糕	方糕	方糕	faon kau
方丈和尚	方丈和尚	方丈和尚	faon jian ghou zaon
方頓頓	方顿顿	方頓頓	faon ten ten
方巾	方巾	方巾	faon cin
方桌	方桌	方桌	faon tsoq
方桌凳	方桌凳	方桌凳	faon tsoq ten
方角	方角	方角	faon koq
紡花車	纺花车	紡花車	faon huo tsho
放水	放水	放水	faon syu
放樹	放树	放樹	faon zyu
放鷄	放鸡	放雞	faon ci
放焰口	放焰口	放焰口	faon yi kheu
放大鏡	放大镜	放大鏡	faon da cin
放炮仗	放炮仗	放炮仗	faon phau jian
放假	放假	放假	faon ko
放花筒	放花筒	放花筒	faon huo don
放手	放手	放手	faon shieu
放生	放生	放生	faon san
放湯	放汤	放湯	faon thaon
放湯飯	放汤饭	放湯飯	faon thaon vae
放命	放命	放命	faon min
放命頭	放命头	放命頭	faon min deu
放心	放心	放心	faon shin
放筒銃	放筒铳	放筒銃	faon don tshon
放白鴿	放白鸽	放白鴿	faon baq kaq
放學	放学	放學	faon ghoq
放晝學	放昼学	放晝學	faon cieu ghoq
放夜學	放夜学	放夜學	faon ya ghoq
放血	放血	放血	faon shiuq
房	房	房	vaon2
房子	房子	房子	vaon tsy
房屋	房屋	房屋	vaon oq
房鈿	房钿	房鈿	vaon di
房間	房间	房間	vaon kae
房門	房门	房門	vaon men
房東	房东	房東	vaon ton
房空	房空	房空	vaon khon
房客	房客	房客	vaon khaq
望門寡	望门寡	望門寡	vaon men kuo
望門大姑娘	望门大姑娘	望門大姑娘	vaon men dou ku gnian
當○	当○	當○	taon1
當面	当面	當面	taon mi
當家尼姑	当家尼姑	當家尼姑	taon ko gni ku
當家人	当家人	當家人	taon ko gnin
當晝過	当昼过	當晝過	taon cieu kou
當晝過頭	当昼过头	當晝過頭	taon cieu kou deu
當大囡	当大囡	當大囡	taon dou noe
當大兒子	当大儿子	當大兒子	taon dou ng tsy
當忙	当忙	當忙	taon maon
當即	当即	當即	taon ciq
當心	当心	當心	taon shin
當中	当中	當中	taon tson
當中央	当中央	當中央	taon tson gnian
當中央央	当中央央	當中央央	taon tson gnian gnian
當中央亨	当中央亨	當中央亨	taon tson gnian han
當值	当值	當值	taon jiq
當月	当月	當月	taon yuq
鐺鐺響	铛铛响	鐺鐺響	taon taon shian
當	当	當	taon5
當店	当店	當店	taon ti
當鋪	当铺	當鋪	taon phu
當票	当票	當票	taon phiau
擋	挡	擋	taon5
擋頑	挡顽	擋頑	taon uae
擋瞎眼	挡瞎眼	擋瞎眼	taon haq ngae
淌白	淌白	淌白	thaon baq
湯	汤	湯	thaon1
湯水	汤水	湯水	thaon syu
湯麵	汤面	湯麪	thaon mi
湯飯	汤饭	湯飯	thaon vae
湯糰	汤团	湯糰	thaon doe
湯鍋	汤锅	湯鍋	thaon kou
湯果	汤果	湯果	thaon kou
湯果粉	汤果粉	湯果粉	thaon kou fen
湯碗	汤碗	湯碗	thaon un
湯盅	汤盅	湯盅	thaon tson
湯藥	汤药	湯藥	thaon yaq
耥	耥	耥	thaon5
耥田	耥田	耥田	thaon di
燙衣裳	烫衣裳	燙衣裳	thaon i zaon
燙壺子	烫壶子	燙壺子	thaon wu tsy
燙盤子	烫盘子	燙盤子	thaon bun tsy
燙婆子	烫婆子	燙婆子	thaon bou tsy
燙水壺	烫水壶	燙水壺	thaon syu wu
燙開	烫开	燙開	thaon khe
燙煞	烫煞	燙煞	thaon saq
燙煞鬼	烫煞鬼	燙煞鬼	thaon saq ciu
堂前	堂前	堂前	daon zhi
堂房	堂房	堂房	daon vaon
堂房姊妹	堂房姊妹	堂房姊妹	daon vaon ci mei
堂姊妹	堂姊妹	堂姊妹	daon ci mei
堂房兄弟	堂房兄弟	堂房兄弟	daon vaon shion di
堂兄弟	堂兄弟	堂兄弟	daon shion di
堂倌	堂倌	堂倌	daon kun
跑堂個	跑堂个	跑堂個	bau daon goq
堂阿弟	堂阿弟	堂阿弟	daon aq di
堂阿姐	堂阿姐	堂阿姐	daon aq cia
堂阿妹	堂阿妹	堂阿妹	daon aq mei
堂阿哥	堂阿哥	堂阿哥	daon aq kou
堂鑊	堂镬	堂鑊	daon ghoq
搪	搪	搪	daon2
溏黄	溏黄	溏黃	daon uaon
糖炒栗子	糖炒栗子	糖炒栗子	daon tshau liq tsy
糖茶	糖茶	糖茶	daon dzo
糖氽蛋	糖氽蛋	糖氽蛋	daon then dae
鏜鋃銀子	镗锒银子	鏜鋃銀子	daon laon gnin tsy
蕩	荡	蕩	daon4
蕩個月	荡个月	蕩個月	daon kou yuq
蕩個月	荡个月	蕩個月	daon goq yuq
蕩頭	荡头	蕩頭	daon deu
蕩底	荡底	蕩底	daon ti
蕩底把	荡底把	蕩底把	daon ti po
蕩𡍲	荡𡍲	蕩𡍲	daon thaq
蕩槍○	荡枪○	蕩槍○	daon chian
蕩槍裏○	荡枪里○	蕩槍裏○	daon chian li
蕩横	荡横	蕩橫	daon wan
蕩横裏	荡横里	蕩橫裏	daon wan li
蕩個	荡个	蕩個	daon goq
蕩個	荡个	蕩個	daon kou
盪	荡	盪	daon4
盪嘴巴	荡嘴巴	盪嘴巴	daon tsyu po
盪秋千	荡秋千	盪鞦韆	daon chieu chi
盪口杯	荡口杯	盪口杯	daon kheu pei
儾	儾	儾	naon6
儾舒	儾舒	儾舒	naon syu
儾頭	儾头	儾頭	naon deu
郎丫扁擔	郎丫扁担	郎丫扁擔	laon o pi tae
郎中	郎中	郎中	laon tson
蓈花	蓈花	蓈花	laon huo
朗炕	朗炕	朗炕	laon haon
廊檐	廊檐	廊檐	laon yi
榔頭	榔头	榔頭	laon deu
踉䠀	踉䠀	踉䠀	laon thaon
誏話	誏话	誏話	lhaon wo
浪○	浪○	浪○	laon4
浪○泛泛	浪○泛泛	浪○泛泛	laon fae fae
浪頭	浪头	浪頭	laon deu
浪	浪	浪	laon6
浪喫浪用	浪吃浪用	浪吃浪用	laon chioq laon yon
浪食	浪食	浪食	laon zhiq
㫰	㫰	㫰	laon6
㫰竿	㫰竿	㫰竿	laon kI
㫰衣裳	㫰衣裳	㫰衣裳	laon i zaon
㫰衣墩	㫰衣墩	㫰衣墩	laon i ten
㫰丫叉	㫰丫叉	㫰丫叉	laon o tsho
㫰霉	㫰霉	㫰黴	laon mei
𧻴趤公子	𧻴趤公子	𧻴趤公子	laon daon kon tsy
妝粉	妆粉	妝粉	tsaon fen
莊	庄	莊	tsaon1
莊家	庄家	莊家	tsaon ko
章程	章程	章程	tsaon jin
裝	装	裝	tsaon1
裝意基○	装意基○	裝意基○	tsaon i ci
裝大糊	装大糊	裝大糊	tsaon dou wu
裝特戇	装特戆	裝特戇	tsaon daq gaon
裝樣	装样	裝樣	tsaon yan
裝白泥其	装白泥其	裝白泥其	tsaon baq gni ji
樟樹	樟树	樟樹	tsaon zyu
樟木箱	樟木箱	樟木箱	tsaon moq shian
樁	桩	樁	tsaon1
蟑螂	蟑螂	蟑螂	tsaon laon
壯	壮	壯	tsaon5
壯搭搭	壮搭搭	壯搭搭	tsaon taq taq
葬落	葬落	葬落	tsaon loq
菖蒲	菖蒲	菖蒲	tshaon bu
窗簾	窗帘	窗簾	tshaon li
窗外	窗外	窗外	tshaon nga
窗頭	窗头	窗頭	tshaon deu
窗頭口	窗头口	窗頭口	tshaon deu kheu
窗口頭	窗口头	窗口頭	tshaon kheu deu
窗口	窗口	窗口	tshaon kheu
窗門	窗门	窗門	tshaon men
窗檻	窗槛	窗檻	tshaon khae
蒼蠅	苍蝇	蒼蠅	tshaon in
蒼蠅拍	苍蝇拍	蒼蠅拍	tshaon in phaq
闖禍坯	闯祸坯	闖禍坯	tshaon ghou phei
唱定心歌	唱定心歌	唱定心歌	tshaon din shin kou
唱功	唱功	唱功	tshaon kon
創○羹桶	创○羹桶	創○羹桶	tshaon kan don
摐	𪭢	摐	tshaon5
幢	幢	幢	dzaon4
幢籃	幢篮	幢籃	dzaon lae
幢箱櫥	幢箱橱	幢箱櫥	dzaon shian dzyu
撞頭	撞头	撞頭	dzaon deu
撞傷	撞伤	撞傷	dzaon saon
藏青	藏青	藏青	dzaon chin
桑樹	桑树	桑樹	saon zyu
桑果	桑果	桑果	saon kou
桑葉	桑叶	桑葉	saon yiq
舂	舂	舂	saon1
舂米	舂米	舂米	saon mi
喪事	丧事	喪事	saon zy
傷	伤	傷	saon1
傷料	伤料	傷料	saon liau
傷寒氣	伤寒气	傷寒氣	saon ghEI chi
傷陰騭	伤阴骘	傷陰騭	saon in ciq
傷風氣	伤风气	傷風氣	saon fon chi
傷風	伤风	傷風	saon fon
霜	霜	霜	saon1
霜降	霜降	霜降	saon kaon
雙	双	雙	saon1
雙胞胎	双胞胎	雙胞胎	saon pau the
雙臺下巴	双台下巴	雙臺下巴	saon de gho po
雙隑人	双隑人	雙隑人	saon ge gnin
雙嵌麻糰	双嵌麻团	雙嵌麻糰	saon khae mo doe
雙眼沿	双眼沿	雙眼沿	saon ngae yi
雙旋	双旋	雙旋	saon zoe
雙鱟	双鲎	雙鱟	saon heu
雙缸醬	双缸酱	雙缸醬	saon kaon cian
雙滿月	双满月	雙滿月	saon mun yuq
爽	爽	爽	saon3
爽氣	爽气	爽氣	saon chi
爽爽氣氣	爽爽气气	爽爽氣氣	saon saon chi chi
爽性	爽性	爽性	saon shin
磉子	磉子	磉子	saon tsy
磉盤	磉盘	磉盤	saon bun
磉盤石	磉盘石	磉盤石	saon bun zaq
搡	搡	搡	saon5
牀	床	牀	zaon2
牀匾	床匾	牀匾	zaon pi
牀底下	床底下	牀底下	zaon ti gho
牀罩	床罩	牀罩	zaon tsau
牀頭鬼	床头鬼	牀頭鬼	zaon deu ciu
牀横頭	床横头	牀橫頭	zaon wan deu
牀桯	床桯	牀桯	zaon thin
牀公牀婆	床公床婆	牀公牀婆	zaon kon zaon bou
嘗鹹淡	尝咸淡	嚐鹹淡	zaon ghae dae
上市	上市	上市	zaon zy
上市貨	上市货	上市貨	zaon zy hou
上水魚	上水鱼	上水魚	zaon syu ng
上點心	上点心	上點心	zaon ti shin
上點心	上点心	上點心	zaon te shin
上路	上路	上路	zaon lu
上訴	上诉	上訴	zaon su
上階沿	上阶沿	上階沿	zaon ka yi
上竈師父	上灶师父	上竈師父	zaon tsau sy vu
上家	上家	上家	zaon ko
上照	上照	上照	zaon ciau
上轎飯	上轿饭	上轎飯	zaon jiau vae
上菜	上菜	上菜	zaon tshe
上山	上山	上山	zaon sae
上山襪	上山袜	上山襪	zaon sae maq
上算	上算	上算	zaon soe
上圍	上围	上圍	zaon wei
上個月	上个月	上個月	zaon kou yuq
上個月	上个月	上個月	zaon goq yuq
上課	上课	上課	zaon khou
上頭	上头	上頭	zaon deu
上梁	上梁	上樑	zaon lian
上梁酒	上梁酒	上樑酒	zaon lian cieu
上兩日	上两日	上兩日	zaon lian gniq
上槍○	上枪○	上槍○	zaon chian
上一槍○	上一枪○	上一槍○	zaon iq chian
上香	上香	上香	zaon shian
上横頭	上横头	上橫頭	zaon wan deu
上首	上首	上首	zaon shieu
上裝	上装	上裝	zaon tsaon
上半年	上半年	上半年	zaon pun gni
上半夜	上半夜	上半夜	zaon pun ya
上半日	上半日	上半日	zaon pun gniq
上半日頭	上半日头	上半日頭	zaon pun gniq deu
上門女婿	上门女婿	上門女婿	zaon men gniu shi
上墳	上坟	上墳	zaon ven
上墳羹飯	上坟羹饭	上墳羹飯	zaon ven kan vae
上登	上登	上登	zaon ten
上燈夜	上灯夜	上燈夜	zaon ten ya
上濎下輕	上濎下轻	上濎下輕	zaon tin gho chin
上林湖青瓷窰址	上林湖青瓷窑址	上林湖青瓷窯址	zaon lin wu chin dzy yau tsy
上疄頭	上疄头	上疄頭	zaon lin deu
上任	上任	上任	zaon gnin
上身	上身	上身	zaon shin
上刑罰	上刑罚	上刑罰	zaon yin vaq
上春頭	上春头	上春頭	zaon tshyun deu
上風頭	上风头	上風頭	zaon fon deu
上工	上工	上工	zaon kon
上軛	上轭	上軛	zaon aq
上落	上落	上落	zaon loq
上上落落	上上落落	上上落落	zaon zaon loq loq
上落先生	上落先生	上落先生	zaon loq shi san
上學	上学	上學	zaon ghoq
上學生仔	上学生仔	上學生仔	zaon ghoq san tsy
尚怕	尚怕	尚怕	zaon pho
狀子	状子	狀子	zaon tsy
晌	晌	晌	zaon4
鞝鞋	绱鞋	鞝鞋	zaon gha
江	江	江	kaon1
江湖郎中	江湖郎中	江湖郎中	kaon wu laon tson
江貓	江猫	江貓	kaon mae
江白蝦	江白虾	江白蝦	kaon baq huo
肛門	肛门	肛門	kaon men
缸	缸	缸	kaon1
缸竈	缸灶	缸竈	kaon tsau
缸砂	缸砂	缸砂	kaon so
剛剛	刚刚	剛剛	kaon kaon
豇豆	豇豆	豇豆	kaon deu
鋼絲	钢丝	鋼絲	kaon sy
鋼絲牀	钢丝床	鋼絲牀	kaon sy zaon
鋼針	钢针	鋼針	kaon cin
鋼中○	钢中○	鋼中○	kaon tson
鋼筆	钢笔	鋼筆	kaon piq
鋼筆頭	钢笔头	鋼筆頭	kaon piq deu
港汊	港汊	港汊	kaon tsho
講書	讲书	講書	kaon syu
講起埭頭	讲起埭头	講起埭頭	kaon chi da deu
講纏話	讲缠话	講纏話	kaon ji wo
講武書	讲武书	講武書	kaon Wu syu
講大道	讲大道	講大道	kaon da dau
講聊天	讲聊天	講聊天	kaon liau thi
講夜話	讲夜话	講夜話	kaon ya wo
講臺	讲台	講臺	kaon de
講閑話	讲闲话	講閒話	kaon ghae wo
講説話	讲说话	講說話	kaon syuq wo
講究	讲究	講究	kaon cieu
講大話	讲大话	講大話	kaon da wo
講正頭	讲正头	講正頭	kaon cin deu
講勿來	讲勿来	講勿來	kaon vaq le
講勿睬	讲勿睬	講勿睬	kaon vaq tshe
講勿理踩	讲勿理踩	講勿理踩	kaon vaq li tshe
講勒來	讲勒来	講勒來	kaon laq le
杠箱	杠箱	槓箱	kaon shian
囥	囥	囥	khaon5
㽘	㽘	㽘	gaon2
㽘杴	㽘锨	㽘杴	gaon shi
扛	扛	扛	gaon2
扛	扛	扛	kaon1
扛	扛	扛	gaon6
戇	戆	戇	gaon4
戇性性	戆性性	戇性性	gaon shin shin
戇得得	戆得得	戇得得	gaon taq taq
戇大	戆大	戇大	gaon dou
戇大女婿	戆大女婿	戇大女婿	gaon dou gniu shi
戇戇鵝	戆戆鹅	戇戇鵝	gaon gaon ngou
行	行	行	ghaon2
行俏	行俏	行俏	ghaon chiau
行販	行贩	行販	ghaon fae
行會	行会	行會	ghaon wei
行當	行当	行當	ghaon taon
行情行市	行情行市	行情行市	ghaon jin ghaon zy
行勿住	行勿住	行勿住	ghaon vaq dzyu
行勿消	行勿消	行勿消	ghaon vaq shiau
行勒住	行勒住	行勒住	ghaon laq dzyu
行勒消	行勒消	行勒消	ghaon laq shiau
杭州籃	杭州篮	杭州籃	ghaon cieu lae
航船	航船	航船	ghaon zOE
絎	绗	絎	ghaon2
絎針	绗针	絎針	ghaon cin
項圈	项圈	項圈	ghaon chiu
盎○	盎○	盎○	aon1
盎○拔拔	盎○拔拔	盎○拔拔	aon baq baq
盎○拔幾糟	盎○拔几糟	盎○拔幾糟	aon baq ci tsau
䱀顙魚	𫚐颡鱼	䱀顙魚	aon saon ng
光是	光是	光是	kuaon zy
光芋	光芋	光芋	kuaon gniu
光榔頭	光榔头	光榔頭	kuaon laon deu
光禿芋艿頭	光秃芋艿头	光禿芋艿頭	kuaon thaq n na deu
光棍	光棍	光棍	kuaon kuen
光棍老倌	光棍老倌	光棍老倌	kuaon kuen lau kun
廣告	广告	廣告	kuaon kau
廣貨店	广货店	廣貨店	kuaon hou ti
廣橘	广橘	廣橘	kuaon ciuq
杠棍	杠棍	杠棍	kuaon kuen
狂風	狂风	狂風	guaon fon
荒地	荒地	荒地	huaon di
慌氣	慌气	慌氣	huaon chi
慌稀稀	慌稀稀	慌稀稀	huaon shi shi
慌急慌忙	慌急慌忙	慌急慌忙	huaon ciq huaon maon
王八	王八	王八	waon pa
王婆	王婆	王婆	waon bou
皇曆	皇历	皇曆	waon liq
黄	黄	黃	waon2
黄鼠狼	黄鼠狼	黃鼠狼	waon tsy laon
黄蜆	黄蚬	黃蜆	waon shi
黄狗	黄狗	黃狗	waon kI
黄狗	黄狗	黃狗	wu kI
黄鱔	黄鳝	黃鱔	waon yi
黄鱔骨	黄鳝骨	黃鱔骨	waon yi kuaq
黄煙	黄烟	黃菸	waon i
黄古古	黄古古	黃古古	waon ku ku
黄包車	黄包车	黃包車	waon pau tsho
黄包車夫	黄包车夫	黃包車伕	waon pau tsho fu
黄道吉日	黄道吉日	黃道吉日	waon dau ciq gniq
黄糙米	黄糙米	黃糙米	waon tshau mi
黄沙	黄沙	黃沙	waon so
黄瓜	黄瓜	黃瓜	waon kuo
黄巖蜜橘	黄岩蜜橘	黃巖蜜橘	waon ngae miq ciuq
黄泉路	黄泉路	黃泉路	waon dzOE lu
黄梅天	黄梅天	黃梅天	waon mei thi
黄霉天	黄霉天	黃黴天	waon mei thi
黄𤿏糕	黄𤿏糕	黃𤿏糕	waon nei kau
黄婆鷄	黄婆鸡	黃婆雞	waon bou ci
黄頭貓	黄头猫	黃頭貓	waon deu mae
黄豆	黄豆	黃豆	waon deu
黄豆芽	黄豆芽	黃豆芽	waon deu ngo
黄豆湯	黄豆汤	黃豆湯	waon deu thaon
黄牛	黄牛	黃牛	waon ngeu
黄牛肩胛	黄牛肩胛	黃牛肩胛	waon ngeu ci kaq
黄蜢	黄蜢	黃蜢	waon man
黄亨亨	黄亨亨	黃亨亨	waon han han
黄腸癟西	黄肠瘪西	黃腸癟西	waon jian piq shi
黄楊	黄杨	黃楊	waon yan
黄楊樹	黄杨树	黃楊樹	waon yan zyu
黄央央	黄央央	黃央央	waon ian ian
黄胖	黄胖	黃胖	waon phaon
黄糖	黄糖	黃糖	waon daon
黄金瓜	黄金瓜	黃金瓜	waon cin kuo
黄昏曉	黄昏晓	黃昏曉	waon huen shiau
黄昏頭	黄昏头	黃昏頭	waon huen deu
胡○喚○頭	胡○唤○头	胡○喚○頭	wu hun deu
黄蜂	黄蜂	黃蜂	waon fon
黄蜂窠	黄蜂窠	黃蜂窠	waon fon khou
黄銅	黄铜	黃銅	waon don
黄齈鼻頭	黄齈鼻头	黃齈鼻頭	waon nhon baq deu
黄終爛熟	黄终烂熟	黃終爛熟	waon tson lae zoq
黄鮚	黄鲒	黃鮚	waon ciq
黄魚	黄鱼	黃魚	waon ng
黄魚車	黄鱼车	黃魚車	waon ng tsho
惶恐	惶恐	惶恐	waon khon
旺	旺	旺	waon6
旺旺動	旺旺动	旺旺動	waon waon don
旺興丁	旺兴丁	旺興丁	waon shin tin
旺七旺八	旺七旺八	旺七旺八	waon chiq waon paq
旺三無陳	旺三无陈	旺三無陳	waon sae vu jin
旺興夾腳	旺兴夹脚	旺興夾腳	waon shin kaq ciaq
旺興帶淖泥	旺兴带淖泥	旺興帶淖泥	waon shin ta na gni
黄汗	黄汗	黃汗	waon ghEI
黄汗活崩	黄汗活崩	黃汗活崩	waon ghEI waq pon
滉	滉	滉	waon6
望	望	望	uaon1
黄	黄	黃	uaon3
黄蒲蒲	黄蒲蒲	黃蒲蒲	uaon bu bu
枉爲	枉为	枉爲	uaon wei
曂亮	曂亮	曂亮	uaon lian
搬嫁資衣	搬嫁资衣	搬嫁資衣	pun ko tsy i
搬嫁妝	搬嫁妆	搬嫁妝	pun ko tsaon
搬屋	搬屋	搬屋	pun oq
半雌雄	半雌雄	半雌雄	pun tshy yon
半邊風	半边风	半邊風	pun pi fon
半肢風	半肢风	半肢風	pun tsy fon
半路裏	半路里	半路里	pun lu li
半夜餐	半夜餐	半夜餐	pun ya tshae
半夜三更	半夜三更	半夜三更	pun ya sae kan
半夜裏	半夜里	半夜裏	pun ya li
半夜過	半夜过	半夜過	pun ya kou
半山腰	半山腰	半山腰	pun sae iau
半生裏熟	半生里熟	半生裏熟	pun san li zoq
半當中央	半当中央	半當中央	pun taon tson gnian
半中央亨	半中央亨	半中央亨	pun tson gnian han
半半六十日	半半六十日	半半六十日	pun pun loq zyuq gniq
半中大	半中大	半中大	pun tson dou
半弗牢告	半弗牢告	半弗牢告	pun faq lau kau
半弗冷打	半弗冷打	半弗冷打	pun faq lan tan
半𥏘觀音	半𥏘观音	半𥏘觀音	pun jiuq kun in
半個	半个	半個	pun kou
半個	半个	半個	pun goq
半日	半日	半日	pun gniq
判	判	判	phun5
判官	判官	判官	phun kun
盤	盘	盤	bun2
盤	盘	盤	phun1
盤麵	盘面	盤面	bun mi
盤纏鈿	盘缠钿	盤纏鈿	bun ji di
盤貨	盘货	盤貨	bun hou
盤香紐	盘香纽	盤香紐	bun shian gnieu
盤進	盘进	盤進	bun cin
盤骨	盘骨	盤骨	bun kuaq
盤出	盘出	盤出	bun tshyuq
蟠桃	蟠桃	蟠桃	bun dau
伴手果	伴手果	伴手果	bun shieu kou
鞔白鞋	鞔白鞋	鞔白鞋	mun baq gha
饅頭	馒头	饅頭	mun deu
鰻	鳗	鰻	mun2
鰻鯗	鳗鲞	鰻鯗	mun shian
鰻筒	鳗筒	鰻筒	mun don
㒼	㒼	㒼	mun6
㒼襠褲	㒼裆裤	㒼襠褲	mun taon khu
滿師	满师	滿師	mun sy
滿嘴滿得	满嘴满得	滿嘴滿得	mun tsyu mun taq
滿孝	满孝	滿孝	mun hau
滿堂紅	满堂红	滿堂紅	mun daon ghon
滿進隔○出	满进隔○出	滿進隔○出	mun cin kaq tshyuq
滿月	满月	滿月	mun yuq
滿月酒	满月酒	滿月酒	mun yuq cieu
官司	官司	官司	kun sy
官司草	官司草	官司草	kun sy tshau
棺材	棺材	棺材	kun ze
管	管	管	kun3
灌水	灌水	灌水	kun syu
罐頭	罐头	罐頭	kun deu
觀音菩薩	观音菩萨	觀音菩薩	kun in bu saq
觀世音菩薩	观世音菩萨	觀世音菩薩	kun syu in bu saq
觀音娘娘	观音娘娘	觀音娘娘	kun in gnian gnian
觀音暴	观音暴	觀音暴	kun in pau
寬	宽	寬	khun1
寬舒	宽舒	寬舒	khun syu
寬緊帶	宽紧带	寬緊帶	khun cin ta
寬搭搭	宽搭搭	寬搭搭	khun taq taq
歡喜	欢喜	歡喜	hun shi
喚	唤	喚	hun5
換身衣裳	换身衣裳	換身衣裳	wun shin i zaon
緩泛	缓泛	緩泛	wun fae
緩泛泛	缓泛泛	緩泛泛	wun fae fae
緩泛頭	缓泛头	緩泛頭	wun fae deu
緩調○彈○	缓调○弹○	緩調○彈○	wun diau dae
緩拖拖	缓拖拖	緩拖拖	wun thou thou
碗	碗	碗	un3
碗底	碗底	碗底	un ti
碗爿	碗爿	碗爿	un bae
碗盞	碗盏	碗盞	un tsae
碗頭碗面	碗头碗面	碗頭碗麪	un deu un mi
碗腳	碗脚	碗腳	un cian
碗腳	碗脚	碗腳	un ciaq
碗行	碗行	碗行	un ghaon
碗桶	碗桶	碗桶	un don
碗葱	碗葱	碗蔥	un tshon
碗頭葱	碗头葱	碗頭蔥	un deu tshon
碗桌底	碗桌底	碗桌底	un tsoq ti
畚	畚	畚	pen1
畚斗	畚斗	畚斗	pen teu
本	本	本	pen3
本事	本事	本事	pen zy
本鈿	本钿	本鈿	pen di
本生	本生	本生	pen san
本當	本当	本當	pen taon
本格	本格	本格	pen kaq
本白	本白	本白	pen baq
奔	奔	奔	pen5
奔來倒去	奔来倒去	奔來倒去	pen le tau chi
奔頭	奔头	奔頭	pen deu
奔喪	奔丧	奔喪	pen saon
奔腳頭	奔脚头	奔腳頭	pen ciaq deu
噴酥	喷酥	噴酥	phen su
噴噴酥	喷喷酥	噴噴酥	phen phen su
噴香	喷香	噴香	phen shian
噴噴香	喷喷香	噴噴香	phen phen shian
噴農藥	喷农药	噴農藥	phen non yaq
坌	坌	坌	ben2
坌地	坌地	坌地	ben di
坌横頭	坌横头	坌橫頭	ben wan deu
盆	盆	盆	ben2
盆子	盆子	盆子	ben tsy
盆子菜	盆子菜	盆子菜	ben tsy tshe
盆頭	盆头	盆頭	ben deu
盆浴	盆浴	盆浴	ben yuq
笨賊佬	笨贼佬	笨賊佬	ben zaq lau
門	门	門	men2
門邊頭	门边头	門邊頭	men pi deu
門邊沿	门边沿	門邊沿	men pi yi
門面	门面	門面	men mi
門簾	门帘	門簾	men li
門裏	门里	門裏	men li
門前牙	门前牙	門前牙	men zhi ngo
門牙	门牙	門牙	men ngo
門路	门路	門路	men lu
門牌號頭	门牌号头	門牌號頭	men ba ghau deu
門檻	门槛	門檻	men khae
門檻精	门槛精	門檻精	men khae cin
門關	门关	門關	men kuae
門軋	门轧	門軋	men gaq
門閂	门闩	門閂	men soe
門鈕	门钮	門鈕	men gnieu
門背後	门背后	門背後	men pei gheu
門⿱咋會介絶	门⿱咋会介绝	門⿱咋會介絕	men dzei ka dzyuq
門口頭	门口头	門口頭	men kheu deu
門口	门口	門口	men kheu
門槍	门枪	門槍	men chian
門枋	门枋	門枋	men faon
門門帳	门门帐	門門帳	men men cian
門桯	门桯	門桯	men thin
門框	门框	門框	men khuaon
門襟	门襟	門襟	men cin
門鈐	门钤	門鈐	men jin
門神	门神	門神	men zyun
門風	门风	門風	men fon
門○蚣	门○蚣	門○蚣	men kon
門栿	门栿	門栿	men boq
蚊蟲	蚊虫	蚊蟲	men dzon
蚊蟲依○絲	蚊虫依○丝	蚊蟲依○絲	men dzon i sy
蚊蟲香	蚊虫香	蚊蟲香	men dzon shian
悶氣特塞	闷气特塞	悶氣特塞	mhen chi daq saq
悶飽	闷饱	悶飽	mhen pau
悶痧	闷痧	悶痧	mhen so
悶冬勿響	闷冬勿响	悶冬勿響	mhen ton vaq shian
悶聲勿響	闷声勿响	悶聲勿響	mhen shin vaq shian
悶洞老虎	闷洞老虎	悶洞老虎	mhen don lau fu
悶拔拔	闷拔拔	悶拔拔	mhen baq baq
燜	焖	燜	mhen5
問	问	問	men6
問簽詩	问签诗	問籤詩	men chi sy
問案	问案	問案	men EI
捫	扪	捫	men6
捫	扪	捫	mhen5
捫碗茶杯	扪碗茶杯	捫碗茶杯	men un dzo pei
分眼分榫	分眼分榫	分眼分榫	fen ngae fen syun
分頭	分头	分頭	fen deu
分○唐○紙	分○唐○纸	分○唐○紙	fen daon tsy
粉	粉	粉	fen3
粉皮	粉皮	粉皮	fen bi
粉綫袋	粉线袋	粉線袋	fen shi de
粉燥	粉燥	粉燥	fen sau
粉粉燥	粉粉燥	粉粉燥	fen fen sau
粉刮斯燥	粉刮斯燥	粉刮斯燥	fen kuaq sy sau
粉刮的燥	粉刮的燥	粉刮的燥	fen kuaq tiq sau
粉蒸肉	粉蒸肉	粉蒸肉	fen cin gnioq
粉紅	粉红	粉紅	fen ghon
粉撲	粉扑	粉撲	fen phoq
粉筆	粉笔	粉筆	fen piq
糞箕	粪箕	糞箕	fen ci
文氣	文气	文氣	ven chi
文文氣氣	文文气气	文文氣氣	ven ven chi chi
文具店	文具店	文具店	ven jiu ti
文旦	文旦	文旦	ven tae
文昌菩薩	文昌菩萨	文昌菩薩	ven tshaon bu saq
文憑	文凭	文憑	ven bin
文明戲	文明戏	文明戲	ven min shi
甮	甮	甮	ven2
甮派	甮派	甮派	ven pha
甮講	甮讲	甮講	ven kaon
墳	坟	墳	ven2
墳墓	坟墓	墳墓	ven mou
墳碑	坟碑	墳碑	ven pei
份	份	份	ven6
登	登	登	ten1
登樣	登样	登樣	ten yan
登登樣樣	登登样样	登登樣樣	ten ten yan yan
燈罩	灯罩	燈罩	ten tsau
燈盞	灯盏	燈盞	ten tsae
燈盞爿	灯盏爿	燈盞爿	ten tsae bae
燈關熓	灯关𤆡	燈關熓	ten kuae u
燈油	灯油	燈油	ten yeu
燈蛾	灯蛾	燈蛾	ten ngou
燈心	灯心	燈心	ten shin
燈心草	灯心草	燈心草	ten shin tshau
燈心梗	灯心梗	燈心梗	ten shin kuan
燈籠	灯笼	燈籠	ten lon
燈籠褲	灯笼裤	燈籠褲	ten lon khu
燈籠辣茄	灯笼辣茄	燈籠辣茄	ten lon laq jie
燈茄	灯茄	燈茄	ten jie
燈椒	灯椒	燈椒	ten ciau
等晌	等晌	等晌	ten zaon
戥	戥	戥	ten3
戥子	戥子	戥子	ten tsy
戥盤	戥盘	戥盤	ten bun
躉注	趸注	躉注	ten tsyu
敦	敦	敦	ten5
頓	顿	頓	ten5
頓枋	顿枋	頓枋	ten faon
頓頓	顿顿	頓頓	ten ten
頓腳	顿脚	頓腳	ten ciaq
凳櫥	凳橱	凳櫥	ten dzyu
燉茶	炖茶	燉茶	ten dzo
燉老酒	炖老酒	燉老酒	ten lau cieu
燉蛋湯	炖蛋汤	燉蛋湯	ten dae thaon
膯牢	膯牢	膯牢	ten lau
吞金子	吞金子	吞金子	then cin tsy
氽	氽	氽	then3
氽○	氽○	氽○	then3
氽○褲阿舅	氽○裤阿舅	氽○褲阿舅	then khu aq jieu
氽○頭髮	氽○头发	氽○頭髮	then deu faq
氽江浮屍	氽江浮尸	氽江浮屍	then kaon veu sy
氽○缺	氽○缺	氽○缺	then chiuq
庉	庉	庉	den2
庉晌	庉晌	庉晌	den zaon
庉門	庉门	庉門	den men
謄	誊	謄	den2
臀肌○	臀肌○	臀肌○	den ci
藤椅	藤椅	藤椅	den i
藤椅	藤椅	藤椅	den iu
藤綳	藤绷	藤繃	den pan
藤韌	藤韧	藤韌	den gnin
騰騰奔	腾腾奔	騰騰奔	den den pen
屯○	屯○	屯○	den6
扽	扽	扽	den6
鈍	钝	鈍	den6
☐頭	☐头	☐頭	nhen deu
能使	能使	能使	nen sy
能可	能可	能可	nen khou
能幹	能干	能幹	nen kI
嫩	嫩	嫩	nen6
嫰勢	嫰势	嫰勢	nen syu
嫩哀哀	嫩哀哀	嫩哀哀	nen e e
嫩頭	嫩头	嫩頭	nen deu
嫩相	嫩相	嫩相	nen shian
嫩笋頭	嫩笋头	嫩筍頭	nen syun deu
惀	惀	惀	len2
惀帶	惀带	惀帶	len ta
輪轉太婆	轮转太婆	輪轉太婆	len tsoe tha bou
輪船	轮船	輪船	len zOE
輪盤	轮盘	輪盤	len bun
輪着	轮着	輪着	len zyuq
尊	尊	尊	tsen1
甑	甑	甑	tsen1
捘	捘	捘	tsen3
忖	忖	忖	tshen3
忖頭	忖头	忖頭	tshen deu
忖紋理	忖纹理	忖紋理	tshen ven li
忖心事	忖心事	忖心事	tshen shin zy
寸金糖	寸金糖	寸金糖	tshen cin daon
襯裏布衫	衬里布衫	襯裏布衫	tshen li pu sae
襯裏褲	衬里裤	襯裏褲	tshen li khu
襯布	衬布	襯布	tshen pu
襯鞋底	衬鞋底	襯鞋底	tshen gha ti
襯衫	衬衫	襯衫	tshen sae
襯頭	衬头	襯頭	tshen deu
襯領	衬领	襯領	tshen lin
襯裙	衬裙	襯裙	tshen jiun
存心	存心	存心	dzen shin
生三	生三	生三	sen sae
生四	生四	生四	sen sy
生油	生油	生油	sen yeu
生髮油	生发油	生髮油	sen faq yeu
孫子	孙子	孫子	sen tsy
孫女婿	孙女婿	孫女婿	sen gniu shi
孫囡	孙囡	孫囡	sen noe
孫新婦	孙新妇	孫新婦	sen shin vu
參燕店	参燕店	蔘燕店	sen i ti
滲	渗	滲	sen5
滲人	渗人	滲人	sen gnin
䚮	䚮	䚮	zen2
層	层	層	zen2
☐	☐	☐	zen6
根	根	根	ken1
根頭	根头	根頭	ken deu
根腳	根脚	根腳	ken ciaq
跟屁屙蟲	跟屁屙虫	跟屁屙蟲	ken phi ou dzon
肯肯	肯肯	肯肯	khen khen
啃	啃	啃	khen3
掯腦子卜	掯脑子卜	掯腦子卜	khen nau tsy boq
艮	艮	艮	gen6
艮古古	艮古古	艮古古	gen ku ku
艮頭艮腦	艮头艮脑	艮頭艮腦	gen deu gen nau
艮頭	艮头	艮頭	gen deu
𨆪	𫏕	𨆪	gen6
狠	狠	狠	hen3
洵	洵	洵	hen5
脪陽𣝗	脪阳𣝗	脪陽𣝗	hen yan waq
浫	浫	浫	hen5
浫水紙	浫水纸	浫水紙	hen syu tsy
☐	☐	☐	hen5
痕	痕	痕	ghen2
恨使命	恨使命	恨使命	ghen sy min
恨使老命	恨使老命	恨使老命	ghen sy lau min
冰	冰	冰	
冰水	冰水	冰水	
冰淇淋	冰淇淋	冰淇淋	
冰冷	冰冷	冰冷	
冰冰冷	冰冰冷	冰冰冷	
冰刮斯冷	冰刮斯冷	冰刮斯冷	
冰冷氣出	冰冷气出	冰冷氣出	
冰糖	冰糖	冰糖	
冰糖甲魚	冰糖甲鱼	冰糖甲魚	
冰瀴	冰瀴	冰瀴	
冰冰瀴	冰冰瀴	冰冰瀴	
冰雹	冰雹	冰雹	
兵	兵	兵	
嬪相	嫔相	嬪相	
丙	丙	丙	
併○	并○	並○	
併下飯	并下饭	並下飯	
併盆籃	并盆篮	並盆籃	
鬢腳	鬓脚	鬢腳	
兵兵球	兵兵球	兵兵球	
蛋殼球	蛋壳球	蛋殼球	
拼盆	拼盆	拼盆	
拼攏	拼拢	拼攏	
姘頭	姘头	姘頭	
品藍	品蓝	品藍	
聘金	聘金	聘金	
聘禮	聘礼	聘禮	
平	平	平	
平地	平地	平地	
平菇	平菇	平菇	
平辈	平辈	平輩	
平房	平房	平房	
平屋	平屋	平屋	
平頂頭	平顶头	平頂頭	
平準	平准	平準	
平腳	平脚	平腳	
平腳板	平脚板	平腳板	
平腳褲	平脚裤	平腳褲	
平鑊蓋	平镬盖	平鑊蓋	
平直	平直	平直	
屏風馬	屏风马	屏風馬	
瓶	瓶	瓶	
瓶蓋頭	瓶盖头	瓶蓋頭	
評書	评书	評書	
蘋果	苹果	蘋果	
蘋果綠	苹果绿	蘋果綠	
病字頭	病字头	病字頭	
病孤獨	病孤独	病孤獨	
民事	民事	民事	
名字戒	名字戒	名字戒	
明年子	明年子	明年子	
明年	明年	明年	
明顯顚	明显顚	明顯顚	
明府鮝	明府鲞	明府鯗	
明朝	明朝	明朝	
明朝子	明朝子	明朝子	
明朝會	明朝会	明朝會	
明蝦	明虾	明蝦	
明當當	明当当	明當當	
明堂	明堂	明堂	
明席	明席	明席	
抿子	抿子	抿子	
抿子梗	抿子梗	抿子梗	
䐇	䐇	䐇	
丁	丁	丁	
丁獅子	丁狮子	丁獅子	
丁崩○擔	丁崩○担	丁崩○擔	
釘	钉	釘	
釘子	钉子	釘子	
釘鞋	钉鞋	釘鞋	
釘耙	钉耙	釘耙	
釘碗	钉碗	釘碗	
頂	顶	頂	
頂頂	顶顶	頂頂	
頂好	顶好	頂好	
頂頭摸腳	顶头摸脚	頂頭摸腳	
頂硬骨粒	顶硬骨粒	頂硬骨粒	
頂僵骨粒	顶僵骨粒	頂僵骨粒	
頂讓	顶让	頂讓	
頂進	顶进	頂進	
頂真	顶真	頂真	
濎	濎	濎	
聽○	听○	聽○	
聽	听	聽	
聽回話	听回话	聽回話	
聽頭	听头	聽頭	
聽頭罐頭	听头罐头	聽頭罐頭	
聽頭貨	听头货	聽頭貨	
聽張	听张	聽張	
聽明	听明	聽明	
挺兵	挺兵	挺兵	
挺卒	挺卒	挺卒	
挺括	挺括	挺括	
停	停	停	
停當	停当	停當	
停停當當	停停当当	停停當當	
定	定	定	
定規	定规	定規	
定堅	定坚	定堅	
定頭鈿	定头钿	定頭鈿	
定頭洋	定头洋	定頭洋	
定洋	定洋	定洋	
定定個	定定个	定定個	
定定心心	定定心心	定定心心	
定親	定亲	定親	
錠	锭	錠	
錠炭	锭炭	錠炭	
拎水	拎水	拎水	
拎包	拎包	拎包	
菱	菱	菱	
菱粉	菱粉	菱粉	
菱角	菱角	菱角	
翎子	翎子	翎子	
零	零	零	
零蛋分	零蛋分	零蛋分	
零蛋	零蛋	零蛋	
零碎	零碎	零碎	
零碎銅鈿	零碎铜钿	零碎銅鈿	
零碎鈔票	零碎钞票	零碎鈔票	
零頭	零头	零頭	
零頭布	零头布	零頭布	
零用鈿	零用钿	零用鈿	
零拆躉買	零拆趸买	零拆躉買	
鄰舍	邻舍	鄰舍	
鄰舍家	邻舍家	鄰舍家	
鄰舍隔壁	邻舍隔壁	鄰舍隔壁	
臨帖	临帖	臨帖	
臨着	临着	臨着	
疄	疄	疄	
疄頭登	疄头登	疄頭登	
靈	灵	靈	
靈巧	灵巧	靈巧	
靈橋牌普通話	灵桥牌普通话	靈橋牌普通話	
靈光	灵光	靈光	
靈清	灵清	靈清	
靈性	灵性	靈性	
令	令	令	
領	领	領	
領圈	领圈	領圈	
領來兒子	领来儿子	領來兒子	
領囡	领囡	領囡	
領頭	领头	領頭	
領口	领口	領口	
領徑	领径	領徑	
領領徑徑	领领径径	領領徑徑	
今年子	今年子	今年子	
今年	今年	今年	
正月	正月	正月	
正月初一	正月初一	正月初一	
正月頭面	正月头面	正月頭面	
正月裏	正月里	正月裏	
正月半	正月半	正月半	
抌	抌	抌	
抌頭	抌头	抌頭	
金	金	金	
金子	金子	金子	
金字招牌	金字招牌	金字招牌	
金錢餅	金钱饼	金錢餅	
金錢蜜橘	金钱蜜橘	金錢蜜橘	
金柑	金柑	金柑	
金彈	金弹	金彈	
金糰	金团	金團	
金猛○	金猛○	金猛○	
金黄	金黄	金黃	
金黄鋥亮	金黄锃亮	金黃鋥亮	
金鈴子	金铃子	金鈴子	
金針	金针	金針	
金針菇	金针菇	金針菇	
金銀花	金银花	金銀花	
金蟲	金虫	金蟲	
金魚	金鱼	金魚	
京戲	京戏	京戲	
真	真	真	
真道話	真道话	真道話	
真可○	真可○	真可○	
真真	真真	真真	
砧板	砧板	砧板	
針屁眼	针屁眼	針屁眼	
針頭	针头	針頭	
針松	针松	針鬆	
針腳	针脚	針腳	
筋骸	筋骸	筋骸	
腈	腈	腈	
經	经	經	
經用	经用	經用	
經摺	经折	經摺	
蒸籠	蒸笼	蒸籠	
蒸籠頭	蒸笼头	蒸籠頭	
蒸籠格	蒸笼格	蒸籠格	
精	精	精	
精鹽	精盐	精鹽	
精瘦刮得	精瘦刮得	精瘦颳得	
精光	精光	精光	
精打光	精打光	精打光	
精光滑脱	精光滑脱	精光滑脫	
精光滑澾	精光滑㳠	精光滑澾	
滑脱精光	滑脱精光	滑脫精光	
滑澾精光	滑㳠精光	滑澾精光	
精光的滑	精光的滑	精光的滑	
精明	精明	精明	
精空	精空	精空	
精空彭空	精空彭空	精空彭空	
驚蟄	惊蛰	驚蟄	
井	井	井	
井窞	井窞	井窞	
枕頭	枕头	枕頭	
枕頭毛巾	枕头毛巾	枕頭毛巾	
枕頭套	枕头套	枕頭套	
枕頭心子	枕头心子	枕頭心子	
胗	胗	胗	
整	整	整	
整夜	整夜	整夜	
整日	整日	整日	
警察爛眼	警察烂眼	警察爛眼	
正	正	正	
正氣	正气	正氣	
正○騸鷄	正○骟鸡	正○騸雞	
正好亦○數	正好亦○数	正好亦○數	
正夠	正够	正夠	
正正夠	正正够	正正夠	
正廂	正厢	正廂	
正堂房	正堂房	正堂房	
正屋	正屋	正屋	
正房	正房	正房	
正式	正式	正式	
浸倭豆芽	浸倭豆芽	浸倭豆芽	
浸種	浸种	浸種	
浸煞	浸煞	浸煞	
進○	进○	進○	
進舍女婿	进舍女婿	進舍女婿	
進賬	进账	進賬	
進場	进场	進場	
進伏	进伏	進伏	
進屋酒	进屋酒	進屋酒	
竟	竟	竟	
竟得	竟得	竟得	
敬酒	敬酒	敬酒	
震	震	震	
鏡子	镜子	鏡子	
證明人	证明人	證明人	
青	青	青	
青衣	青衣	青衣	
青蟹	青蟹	青蟹	
青沙	青沙	青沙	
青沙氣	青沙气	青沙氣	
青條	青条	青條	
青菜	青菜	青菜	
育鱄魚	育𫚋鱼	育鱄魚	
青蒜	青蒜	青蒜	
青糰	青团	青團	
青梅	青梅	青梅	
青大頭	青大头	青大頭	
青大腫	青大肿	青大腫	
青腫	青肿	青腫	
青蘿葡	青萝葡	青蘿葡	
青果	青果	青果	
青果缸	青果缸	青果缸	
青猛○瞎	青猛○瞎	青猛○瞎	
青光眼	青光眼	青光眼	
青櫻櫻	青樱樱	青櫻櫻	
青黄豆	青黄豆	青黃豆	
青金糰	青金团	青金團	
青筋	青筋	青筋	
青春癗	青春癗	青春癗	
青魚	青鱼	青魚	
清水	清水	清水	
清水貨	清水货	清水貨	
清水鼻頭	清水鼻头	清水鼻頭	
清勢勢	清势势	清勢勢	
清道夫	清道夫	清道夫	
清早天亮	清早天亮	清早天亮	
清早	清早	清早	
清頭	清头	清頭	
清口	清口	清口	
清湯	清汤	清湯	
清唱	清唱	清唱	
清爽	清爽	清爽	
清明	清明	清明	
清通	清通	清通	
清一色	清一色	清一色	
稱手	称手	稱手	
輕泛	轻泛	輕泛	
輕泛泛	轻泛泛	輕泛泛	
輕可	轻可	輕可	
輕省	轻省	輕省	
輕輕個	轻轻个	輕輕個	
輕輕叫	轻轻叫	輕輕叫	
輕骨頭	轻骨头	輕骨頭	
蜻蜓	蜻蜓	蜻蜓	
親	亲	親	
親○	亲○	親○	
親事	亲事	親事	
親氣	亲气	親氣	
親眷	亲眷	親眷	
親家	亲家	親家	
親家公	亲家公	親家公	
親家姆	亲家姆	親家姆	
親生	亲生	親生	
親親眷眷	亲亲眷眷	親親眷眷	
蟶子	蛏子	蟶子	
頃刻	顷刻	頃刻	
請先生	请先生	請先生	
請菩薩	请菩萨	請菩薩	
請人客	请人客	請人客	
請客	请客	請客	
請帖	请帖	請帖	
請出轎	请出轿	請出轎	
秤	秤	秤	
秤錘	秤锤	秤錘	
秤砣	秤砣	秤砣	
秤桿	秤杆	秤桿	
秤花	秤花	秤花	
秤紐	秤纽	秤紐	
秤手	秤手	秤手	
秤鈎	秤钩	秤鉤	
秤盤	秤盘	秤盤	
秤○盯	秤○盯	秤○盯	
趁	趁	趁	
趁早	趁早	趁早	
撳	揿	撳	
撳紐	揿纽	撳紐	
撳釘	揿钉	撳釘	
仍規	仍规	仍規	
成	成	成	
成糖	成糖	成糖	
成攏	成拢	成攏	
成藥	成药	成藥	
芹菜	芹菜	芹菜	
城	城	城	
城裏人	城里人	城裏人	
城裏頭人	城里头人	城裏頭人	
城裏頭	城里头	城裏頭	
城外頭	城外头	城外頭	
城牆	城墙	城牆	
城隍老爺	城隍老爷	城隍老爺	
城隍廟	城隍庙	城隍廟	
城門	城门	城門	
埕	埕	埕	
埕頭泥	埕头泥	埕頭泥	
情致	情致	情致	
陳皮	陈皮	陳皮	
陳貨	陈货	陳貨	
勤力	勤力	勤力	
澄○𠗶	澄○𠗶	澄○𠗶	
澄○𠗶	澄○𠗶	澄○𠗶	
擎	擎	擎	
近𥉻眼	近𥉻眼	近𥉻眼	
近視眼	近视眼	近視眼	
近横裏	近横里	近橫裏	
勁道	劲道	勁道	
勁○轉	劲○转	勁○轉	
勁○勁○走	劲○劲○走	勁○勁○走	
陣	阵	陣	
陣頭雨	阵头雨	陣頭雨	
剩	剩	剩	
鈐	钤	鈐	
盡○走	尽○走	盡○走	
凚	凚	凚	
人	人	人	
人意	人意	人意	
人家	人家	人家	
人來瘋	人来疯	人來瘋	
人客瘋	人客疯	人客瘋	
人案	人案	人案	
人案	人案	人案	
人案頭	人案头	人案頭	
人案頭	人案头	人案頭	
人頭	人头	人頭	
人客	人客	人客	
寧波灘簧	宁波滩簧	寧波灘簧	
寧波走書	宁波走书	寧波走書	
寧波評話	宁波评话	寧波評話	
寧席	宁席	寧席	
銀子	银子	銀子	
銀灰	银灰	銀灰	
銀樓	银楼	銀樓	
銀杏	银杏	銀杏	
銀杏樹	银杏树	銀杏樹	
銀匠	银匠	銀匠	
銀洋鈿	银洋钿	銀洋鈿	
銀角子	银角子	銀角子	
銀魚	银鱼	銀魚	
銀魚絲	银鱼丝	銀魚絲	
凝攏	凝拢	凝攏	
壬	壬	壬	
垽	垽	垽	
韌	韧	韌	
韌皮皮	韧皮皮	韌皮皮	
韌皮刁起	韧皮刁起	韌皮刁起	
韌的的	韧的的	韌的的	
韌接接	韧接接	韌接接	
認	认	認	
認生頭	认生头	認生頭	
課真話	课真话	課真話	
認得	认得	認得	
升級	升级	升級	
心	心	心	
心肚	心肚	心肚	
心焦	心焦	心焦	
心花開	心花开	心花開	
心煩幾糟	心烦几糟	心煩幾糟	
心相	心相	心相	
心網	心网	心網	
心痛	心痛	心痛	
心塞眼閉	心塞眼闭	心塞眼閉	
心戳煞	心戳煞	心戳煞	
心急	心急	心急	
心急慌忙	心急慌忙	心急慌忙	
申	申	申	
申報紙	申报纸	申報紙	
伸懶仗	伸懒仗	伸懶仗	
伸手	伸手	伸手	
身	身	身	
身體	身体	身體	
身架	身架	身架	
身段	身段	身段	
身文	身文	身文	
辛	辛	辛	
星	星	星	
星宿	星宿	星宿	
眚	眚	眚	
新年新歲	新年新岁	新年新歲	
新婦	新妇	新婦	
新花暴熱	新花暴热	新花暴熱	
新花暴時熱	新花暴时热	新花暴時熱	
新娘子	新娘子	新娘子	
新娘	新娘	新娘	
新房	新房	新房	
新房子	新房子	新房子	
新郎官	新郎官	新郎官	
新郎	新郎	新郎	
新人家	新人家	新人家	
新風鳗鮝	新风鳗鲞	新風鰻鯗	
新發財主	新发财主	新發財主	
新肉	新肉	新肉	
腥氣	腥气	腥氣	
腥氣刮得	腥气刮得	腥氣颳得	
腥鹹刮氣	腥咸刮气	腥鹹刮氣	
薪炭店	薪炭店	薪炭店	
聲響	声响	聲響	
擤	擤	擤	
性命結果	性命结果	性命結果	
性性	性性	性性	
信紙	信纸	信紙	
信殼	信壳	信殼	
聖珓	圣珓	聖珓	
興○	兴○	興○	
興致	兴致	興致	
晴天價	晴天价	晴天價	
尋死	寻死	尋死	
尋開心	寻开心	尋開心	
尋幽貓	寻幽猫	尋幽貓	
尋吼勢	寻吼势	尋吼勢	
尋皵頭	寻皵头	尋皵頭	
尋肯頭	寻肯头	尋肯頭	
尋軋迾門	寻轧迾门	尋軋迾門	
尋風涼	寻风凉	尋風涼	
尋着	寻着	尋着	
繩	绳	繩	
甚多莫少	甚多莫少	甚多莫少	
淨更半夜	净更半夜	淨更半夜	
淨根	净根	淨根	
淨根牙	净根牙	淨根牙	
靜注	静注	靜注	
靜注注	静注注	靜注注	
靜靜個	静静个	靜靜個	
靜靜叫	静静叫	靜靜叫	
刑事	刑事	刑事	
行賄	行贿	行賄	
行軍牀	行军床	行軍牀	
引	引	引	
引子	引子	引子	
引犯	引犯	引犯	
引魂幡	引魂幡	引魂幡	
寅	寅	寅	
因掉	因掉	因掉	
陰司鬼	阴司鬼	陰司鬼	
陰靉天價	阴叆天价	陰靉天價	
陰天	阴天	陰天	
陰珓	阴珓	陰珓	
陰壽	阴寿	陰壽	
陰配	阴配	陰配	
陰溝	阴沟	陰溝	
陰㫰布衫	阴㫰布衫	陰㫰布衫	
陰文	阴文	陰文	
陰森森	阴森森	陰森森	
陰𡍲頭	阴𡍲头	陰𡍲頭	
陰𡍲頭裏	阴𡍲头里	陰𡍲頭裏	
陰篤篤	阴笃笃	陰篤篤	
陰曆	阴历	陰曆	
陰騭	阴骘	陰騭	
蔭涼	荫凉	蔭涼	
蔭色○	荫色○	蔭色○	
膺架	膺架	膺架	
樓花	楼花	樓花	
鹰洋	鹰洋	鷹洋	
飲	饮	飲	
飲食店	饮食店	飲食店	
影戲	影戏	影戲	
影戲館	影戏馆	影戲館	
影牆	影墙	影牆	
縈	萦	縈	
隱	隐	隱	
䌥	𦈠	䌥	
䌥被針	𦈠被针	䌥被針	
印泥	印泥	印泥	
印糕	印糕	印糕	
印色紙	印色纸	印色紙	
映起	映起	映起	
洇進	洇进	洇進	
洇濕	洇湿	洇溼	
熨斗	熨斗	熨斗	
應嘴	应嘴	應嘴	
應許	应许	應許	
應酬	应酬	應酬	
𢷍	𢷍	𢷍	
瀴	瀴	瀴	
滾	滚	滾	
滾獅子	滚狮子	滾獅子	
滾水	滚水	滾水	
滾圓	滚圆	滾圓	
滾滾圓	滚滚圆	滾滾圓	
滾得斯圓	滚得斯圆	滾得斯圓	
骨勒斯圓	骨勒斯圆	骨勒斯圓	
滾條	滚条	滾條	
滾燙	滚烫	滾燙	
滾壯	滚壮	滾壯	
滾滾壯	滚滚壮	滾滾壯	
滾壯活脱	滚壮活脱	滾壯活脫	
睏椅	困椅	困椅	
睏椅	困椅	困椅	
睏褲	困裤	困褲	
睏衫	困衫	困衫	
睏晏覺	困晏觉	困晏覺	
睏相	困相	困相	
睏勿着	困勿着	困勿着	
睏落	困落	困落	
睏失覺	困失觉	困失覺	
☐膿	☐脓	☐膿	
昏頭	昏头	昏頭	
昏頭錄○蹱	昏头录○蹱	昏頭錄○蹱	
婚事	婚事	婚事	
葷卜飯	荤卜饭	葷卜飯	
葷腥	荤腥	葷腥	
渾	浑	渾	
渾水	浑水	渾水	
渾淘淘	浑淘淘	渾淘淘	
渾頓頓	浑顿顿	渾頓頓	
渾身	浑身	渾身	
渾濁濁	浑浊浊	渾濁濁	
餛飩	馄饨	餛飩	
餛飩皮子	馄饨皮子	餛飩皮子	
混草	混草	混草	
混堂	混堂	混堂	
混滾	混滚	混滾	
混滾帶側楞	混滚带侧楞	混滾帶側楞	
溫課	温课	溫課	
溫吞	温吞	溫吞	
溫吞水	温吞水	溫吞水	
瘟鷄	瘟鸡	瘟雞	
瘟牲	瘟牲	瘟牲	
瘟跌倒	瘟跌倒	瘟跌倒	
薀藻	蕰藻	薀藻	
穩	稳	穩	
穩篤落主	稳笃落主	穩篤落主	
搵	揾	搵	
莙薘	莙荙	莙薘	
皸	皲	皸	
𧱝	𧱝	𧱝	
𧱝頭子	𧱝头子	𧱝頭子	
裙子	裙子	裙子	
裙褲	裙裤	裙褲	
裙帶麵	裙带面	裙帶面	
燻魚	熏鱼	薰魚	
雲	云	雲	
雲頭	云头	雲頭	
耘田	耘田	耘田	
耘稻	耘稻	耘稻	
閏月	闰月	閏月	
運道	运道	運道	
暈車	晕车	暈車	
暈船	晕船	暈船	
暈暈動	晕晕动	暈暈動	
肫	肫	肫	
準定	准定	準定	
準足	准足	準足	
振	振	振	
皴	皴	皴	
鎮紙	镇纸	鎮紙	
鎮裏	镇里	鎮裏	
春天價	春天价	春天價	
春天	春天	春天	
春卷	春卷	春捲	
春餅	春饼	春餅	
春暴頭	春暴头	春暴頭	
春假	春假	春假	
春花	春花	春花	
春牛圖	春牛图	春牛圖	
春冷	春冷	春冷	
春耕	春耕	春耕	
春分	春分	春分	
春凳	春凳	春凳	
春笋	春笋	春筍	
皴㿭	皴㿭	皴㿭	
椿澳○	椿澳○	椿澳○	
笋	笋	筍	
笋乾	笋干	筍乾	
笋麩鹹𧆌	笋麸咸𧆌	筍麩鹹𧆌	
笋麩黄豆	笋麸黄豆	筍麩黃豆	
榫頭	榫头	榫頭	
人牌	人牌	人牌	
人證	人证	人證	
人情	人情	人情	
人中	人中	人中	
辰	辰	辰	
辰光	辰光	辰光	
神志無至○	神志无至○	神志無至○	
神主牌	神主牌	神主牌	
神經稀稀	神经稀稀	神經稀稀	
神經病	神经病	神經病	
純	纯	純	
純怕	纯怕	純怕	
純光	纯光	純光	
純只	纯只	純只	
純光無之	纯光无之	純光無之	
仞	仞	仞	
任	任	任	
腎	肾	腎	
順埭	顺埭	順埭	
順埭過便	顺埭过便	順埭過便	
順流	顺流	順流	
順順流流	顺顺流流	順順流流	
順湯	顺汤	順湯	
順順湯湯	顺顺汤汤	順順湯湯	
順手	顺手	順手	
順手半邊	顺手半边	順手半邊	
順頭	顺头	順頭	
順風	顺风	順風	
順風耳朵	顺风耳朵	順風耳朵	
順風耳朵	顺风耳朵	順風耳朵	
循規蹈矩	循规蹈矩	循規蹈矩	
循規蹈矩	循规蹈矩	循規蹈矩	
崩脆	崩脆	崩脆	
崩崩脆	崩崩脆	崩崩脆	
捧	捧	捧	
蓬	蓬	蓬	
蓬蒿菜	蓬蒿菜	蓬蒿菜	
塳塵	塳尘	塳塵	
塳灰	塳灰	塳灰	
篷	篷	篷	
懵懂	懵懂	懵懂	
封	封	封	
風	风	風	
風指掐	风指掐	風指掐	
風水	风水	風水	
風水先生	风水先生	風水先生	
風乾栗子	风干栗子	風乾栗子	
風衣	风衣	風衣	
風癱	风瘫	風癱	
風手	风手	風手	
風籮○	风箩○	風籮○	
風涼	风凉	風涼	
風涼皮鞋	风凉皮鞋	風涼皮鞋	
鏤空皮鞋	镂空皮鞋	鏤空皮鞋	
風涼轎	风凉轿	風涼轎	
風箱	风箱	風箱	
風疹塊	风疹块	風疹塊	
風篷	风篷	風篷	
風色	风色	風色	
楓樹	枫树	楓樹	
楓樹葉	枫树叶	楓樹葉	
蜂糖	蜂糖	蜂糖	
瘋狗	疯狗	瘋狗	
鋒快	锋快	鋒快	
風	风	風	
風作爛氣	风作烂气	風作爛氣	
縫蕩	缝荡	縫蕩	
冬至	冬至	冬至	
冬米胖	冬米胖	冬米胖	
冬米大胖	冬米大胖	冬米大胖	
冬米大王	冬米大王	冬米大王	
冬米糖	冬米糖	冬米糖	
冬天價	冬天价	冬天價	
冬菇	冬菇	冬菇	
冬瓜	冬瓜	冬瓜	
冬青樹	冬青树	冬青樹	
冬笋	冬笋	冬筍	
東	东	東	
東錢湖風景區	东钱湖风景区	東錢湖風景區	
東西	东西	東西	
東家	东家	東家	
東半邊	东半边	東半邊	
東面	东面	東面	
端午	端午	端午	
端午粽	端午粽	端午糉	
凍	冻	凍	
凍進	冻进	凍進	
凍掉	冻掉	凍掉	
凍瘃	冻瘃	凍瘃	
棟梁	栋梁	棟樑	
通知	通知	通知	
通條	通条	通條	
通關手	通关手	通關手	
統扯	统扯	統扯	
統扯	统扯	統扯	
統貨	统货	統貨	
統整	统整	統整	
痛稀稀	痛稀稀	痛稀稀	
同年相仿	同年相仿	同年相仿	
同仿年紀	同仿年纪	同仿年紀	
同輩	同辈	同輩	
同庚年紀	同庚年纪	同庚年紀	
同年	同年	同年	
同庚	同庚	同庚	
同鄉人	同乡人	同鄉人	
同行中	同行中	同行中	
同同	同同	同同	
同同到老	同同到老	同同到老	
同學	同学	同學	
同業公會	同业公会	同業公會	
桐子	桐子	桐子	
桐樹	桐树	桐樹	
桐油	桐油	桐油	
童子鷄	童子鸡	童子雞	
童男童女	童男童女	童男童女	
銅	铜	銅	
銅鈿	铜钿	銅鈿	
銅鈿銀子	铜钿银子	銅鈿銀子	
銅千○	铜千○	銅千○	
銅茶壺	铜茶壶	銅茶壺	
銅瓢	铜瓢	銅瓢	
銅板	铜板	銅板	
銅鑼	铜锣	銅鑼	
銅鑼瘡	铜锣疮	銅鑼瘡	
銅匠	铜匠	銅匠	
銅盆柿子	铜盆柿子	銅盆柿子	
銅盆帽	铜盆帽	銅盆帽	
銅盆領	铜盆领	銅盆領	
銅盆魚	铜盆鱼	銅盆魚	
銅勺	铜勺	銅勺	
銅筆套管	铜笔套管	銅筆套管	
銅錫店	铜锡店	銅錫店	
瞳孔	瞳孔	瞳孔	
洞洞眼	洞洞眼	洞洞眼	
洞眼	洞眼	洞眼	
洞殻板	洞壳板	洞殼板	
胴肛	胴肛	胴肛	
胴肛閘○出	胴肛闸○出	胴肛閘○出	
動	动	動	
動氣	动气	動氣	
動土	动土	動土	
動手	动手	動手	
動伙	动伙	動夥	
桶	桶	桶	
桶耳朵皮	桶耳朵皮	桶耳朵皮	
桶耳朵皮	桶耳朵皮	桶耳朵皮	
筒	筒	筒	
筒子	筒子	筒子	
筒頭麵	筒头面	筒頭面	
襛	襛	襛	
膿綫頭	脓线头	膿線頭	
齆	齆	齆	
齆鼻頭	齆鼻头	齆鼻頭	
弄	弄	弄	
龍鬚笋	龙须笋	龍鬚筍	
龍鬚竹	龙须竹	龍鬚竹	
龍蝦	龙虾	龍蝦	
龍頭	龙头	龍頭	
龍頭鮳	龙头鲓	龍頭鮳	
龍頭魚	龙头鱼	龍頭魚	
龍洋	龙洋	龍洋	
龍光閃	龙光闪	龍光閃	
龍山	龙山	龍山	
龍鳳細吹	龙凤细吹	龍鳳細吹	
龍鳳戒	龙凤戒	龍鳳戒	
龍鳳花燭	龙凤花烛	龍鳳花燭	
龍骨	龙骨	龍骨	
龍骨車	龙骨车	龍骨車	
龍骨牆	龙骨墙	龍骨牆	
礱	砻	礱	
礱糠	砻糠	礱糠	
礱穀	砻谷	礱谷	
襱褲	襱裤	襱褲	
聾𦗭	聋𦗭	聾𦗭	
籠	笼	籠	
弄	弄	弄	
弄坊○	弄坊○	弄坊○	
弄堂	弄堂	弄堂	
弄慫	弄怂	弄慫	
弄勿好	弄勿好	弄勿好	
攏總	拢总	攏總	
中指	中指	中指	
中灰	中灰	中灰	
中○牲	中○牲	中○牲	
中央	中央	中央	
中央亨	中央亨	中央亨	
中央人	中央人	中央人	
中堂	中堂	中堂	
中裝	中装	中裝	
中風	中风	中風	
中藥	中药	中藥	
中式褲	中式裤	中式褲	
宗	宗	宗	
宗仰	宗仰	宗仰	
盅	盅	盅	
棕樹	棕树	棕樹	
棕綳	棕绷	棕繃	
棕綳眠牀	棕绷眠床	棕繃眠牀	
棕綳桯	棕绷桯	棕繃桯	
棕綳架子	棕绷架子	棕繃架子	
鐘錶店	钟表店	鐘錶店	
鐘頭	钟头	鐘頭	
腫起	肿起	腫起	
種	种	種	
種豬	种猪	種豬	
總	总	總	
總歸	总归	總歸	
總歸仔	总归仔	總歸仔	
總督羹	总督羹	總督羹	
濁○落羹	浊○落羹	濁○落羹	
總只	总只	總只	
總只介	总只介	總只介	
總只…介𡀂	总只…介𡀂	總只…介𡀂	
衆家	众家	衆家	
種	种	種	
種田人	种田人	種田人	
種田繩	种田绳	種田繩	
種牛痘	种牛痘	種牛痘	
粽子	粽子	糉子	
粽箬	粽箬	糉箬	
充○	充○	充○	
充○手	充○手	充○手	
充公	充公	充公	
沖天炮	冲天炮	沖天炮	
沖口出	冲口出	衝口出	
沖賬	冲账	衝賬	
沖場	冲场	衝場	
沖熱水瓶	冲热水瓶	衝熱水瓶	
葱	葱	蔥	
葱花	葱花	蔥花	
葱油餅	葱油饼	蔥油餅	
葱白	葱白	蔥白	
葱葉	葱叶	蔥葉	
楤擔	楤担	楤擔	
楤杠	楤杠	楤槓	
蹱	蹱	蹱	
蹱去	蹱去	蹱去	
重囡疏○	重囡疏○	重囡疏○	
重囡疏○	重囡疏○	重囡疏○	
重陽暴	重阳暴	重陽暴	
重陽糕	重阳糕	重陽糕	
重陽節	重阳节	重陽節	
重孫	重孙	重孫	
從	从	從	
從此	从此	從此	
從此以後	从此以后	從此以後	
從小	从小	從小	
從今以後	从今以后	從今以後	
從直	从直	從直	
重被	重被	重被	
重頭生活	重头生活	重頭生活	
重頓頓	重顿顿	重頓頓	
訟師	讼师	訟師	
松子	松子	松子	
松子糕	松子糕	松子糕	
松樹	松树	松樹	
松毛	松毛	松毛	
松毛絲	松毛丝	松毛絲	
松香	松香	松香	
松黄	松黄	鬆黃	
松松黄	松松黄	鬆鬆黃	
松得斯黄	松得斯黄	鬆得斯黃	
松木	松木	松木	
鬆撲撲	松扑扑	鬆撲撲	
𢱤	𢱤	𢱤	
聳	耸	聳	
送嫂	送嫂	送嫂	
送娘子	送娘子	送娘子	
送場	送场	送場	
送喪	送丧	送喪	
工鈿	工钿	工鈿	
工人	工人	工人	
弓	弓	弓	
弓長張	弓长张	弓長張	
公路	公路	公路	
公道	公道	公道	
公婆	公婆	公婆	
公公	公公	公公	
拱	拱	拱	
供佛	供佛	供佛	
供	供	供	
貢橘	贡橘	貢橘	
空	空	空	
空势勢	空势势	空勢勢	
空肚	空肚	空肚	
空佬佬	空佬佬	空佬佬	
空頭	空头	空頭	
空頭支票	空头支票	空頭支票	
空省	空省	空省	
空當	空当	空當	
空蕩	空荡	空蕩	
空心板	空心板	空心板	
空心蘿葡	空心萝葡	空心蘿葡	
空心牆	空心墙	空心牆	
空殼	空壳	空殼	
共總	共总	共總	
烘○背	烘○背	烘○背	
哄	哄	哄	
叿	叿	叿	
叿鬧熱	叿闹热	叿鬧熱	
洪峰	洪峰	洪峯	
紅	红	紅	
紅鉗蟹	红钳蟹	紅鉗蟹	
紅稀稀	红稀稀	紅稀稀	
紅霞	红霞	紅霞	
紅毛番薯	红毛番薯	紅毛番薯	
紅毛瓶	红毛瓶	紅毛瓶	
紅毛人	红毛人	紅毛人	
紅毛人案	红毛人案	紅毛人案	
紅毛人案	红毛人案	紅毛人案	
紅棗	红枣	紅棗	
紅燒肉	红烧肉	紅燒肉	
紅花碗	红花碗	紅花碗	
紅蛋	红蛋	紅蛋	
紅莧菜	红苋菜	紅莧菜	
紅丢丢	红丢丢	紅丟丟	
紅緞鑲邊	红缎镶边	紅緞鑲邊	
紅頭	红头	紅頭	
紅頭阿三	红头阿三	紅頭阿三	
紅頭黑炭	红头黑炭	紅頭黑炭	
紅猛日頭	红猛日头	紅猛日頭	
紅醬豆腐	红酱豆腐	紅醬豆腐	
紅腸	红肠	紅腸	
紅幫裁縫	红帮裁缝	紅幫裁縫	
紅幫作頭	红帮作头	紅幫作頭	
紅粉鮮白	红粉鲜白	紅粉鮮白	
紅菱	红菱	紅菱	
紅心番薯	红心番薯	紅心番薯	
紅冬冬	红冬冬	紅鼕鼕	
紅鼻頭管	红鼻头管	紅鼻頭管	
紅腳梗	红脚梗	紅腳梗	
紅木	红木	紅木	
紅出漢○漢○	红出汉○汉○	紅出漢○漢○	
䐥氣	䐥气	䐥氣	
蕹菜	蕹菜	蕹菜	
瓮○衷○	瓮○衷○	甕○衷○	
絨綫	绒线	絨線	
絨綫褲	绒线裤	絨線褲	
絨綫衫	绒线衫	絨線衫	
絨褲	绒裤	絨褲	
絨衫	绒衫	絨衫	
搑	搑	搑	
兄弟	兄弟	兄弟	
兄弟家	兄弟家	兄弟家	
胸脯	胸脯	胸脯	
胸管頭	胸管头	胸管頭	
胸管頭肉	胸管头肉	胸管頭肉	
嗅	嗅	嗅	
嗅嘴	嗅嘴	嗅嘴	
雄驢	雄驴	雄驢	
雄鷄	雄鸡	雄雞	
雄馬	雄马	雄馬	
雄貓	雄猫	雄貓	
雄鴨	雄鸭	雄鴨	
雄鴨	雄鸭	雄鴨	
雄狗	雄狗	雄狗	
雄牛	雄牛	雄牛	
用掉	用掉	用掉	
用場	用场	用場	
用心思	用心思	用心思	
傭人	佣人	傭人	
擁	拥	擁	
壅田	壅田	壅田	
壅料	壅料	壅料	
甬劇	甬剧	甬劇	
甬席	甬席	甬席	
八	八	八	
八字牙鬚	八字牙须	八字牙須	
八字腳	八字脚	八字腳	
八千	八千	八千	
八仙桌	八仙桌	八仙桌	
八號	八号	八號	
八貓介	八猫介	八貓介	
八哥	八哥	八哥	
八分形過	八分形过	八分形過	
八一	八一	八一	
八十一	八十一	八十一	
八二	八二	八二	
八兩	八两	八兩	
八三	八三	八三	
八四	八四	八四	
八五	八五	八五	
八六	八六	八六	
八七	八七	八七	
八八	八八	八八	
八九	八九	八九	
八月十六	八月十六	八月十六	
八十	八十	八十	
不倒翁	不倒翁	不倒翁	
不剌	不剌	不剌	
不剌	不剌	不剌	
百子炮	百子炮	百子炮	
百債	百债	百債	
百把個	百把个	百把個	
百把個	百把个	百把個	
百家衣	百家衣	百家衣	
百家鎖	百家锁	百家鎖	
百襇裙	百裥裙	百襉裙	
百貨店	百货店	百貨店	
百公轎	百公轿	百公轎	
百搭	百搭	百搭	
百腳	百脚	百腳	
百日	百日	百日	
百葉	百叶	百葉	
百葉窗	百叶窗	百葉窗	
伯嚭	伯嚭	伯嚭	
伯婆	伯婆	伯婆	
伯公	伯公	伯公	
柏○	柏○	柏○	
柏樹	柏树	柏樹	
柏油	柏油	柏油	
撥	拨	撥	
把○	把○	把○	
本○	本○	本○	
比○	比○	比○	
撥撥動動	拨拨动动	撥撥動動	
襞	襞	襞	
拍○	拍○	拍○	
拍紙簿	拍纸簿	拍紙簿	
拍馬屁	拍马屁	拍馬屁	
拍手	拍手	拍手	
𤖼	𤖼	𤖼	
𤖼腳	𤖼脚	𤖼腳	
𤖼腳褲	𤖼脚裤	𤖼腳褲	
𤖼腳癩施○	𤖼脚癞施○	𤖼腳癩施○	
𤖼一字	𤖼一字	𤖼一字	
潑便	泼便	潑便	
潑婦	泼妇	潑婦	
白	白	白	
白子	白子	白子	
白市	白市	白市	
白米	白米	白米	
白米蝦	白米虾	白米蝦	
白癜風	白癜风	白癜風	
白鰱	白鲢	白鰱	
白蒲棗	白蒲枣	白蒲棗	
白夫夫	白夫夫	白夫夫	
白肚皮	白肚皮	白肚皮	
白露	白露	白露	
白無常	白无常	白無常	
白蟹	白蟹	白蟹	
白蟹	白蟹	白蟹	
白鞋	白鞋	白鞋	
白帽頭	白帽头	白帽頭	
白䩍䩍	白䩍䩍	白䩍䩍	
白開水	白开水	白開水	
白板	白板	白板	
白籃	白篮	白籃	
白蘭花	白兰花	白蘭花	
白斬鷄	白斩鸡	白斬雞	
白眼	白眼	白眼	
白𤿏糕	白𤿏糕	白𤿏糕	
白大頭	白大头	白大頭	
白蘿葡	白萝葡	白蘿葡	
白果	白果	白果	
白果子	白果子	白果子	
白果樹	白果树	白果樹	
白相果	白相果	白相果	
白相人	白相人	白相人	
白相人嫂嫂	白相人嫂嫂	白相人嫂嫂	
白洋洋	白洋洋	白洋洋	
白楊樹	白杨树	白楊樹	
白糖	白糖	白糖	
白糖砒霜	白糖砒霜	白糖砒霜	
白糖梅子	白糖梅子	白糖梅子	
白金	白金	白金	
白心番薯	白心番薯	白心番薯	
白銅	白铜	白銅	
白白	白白	白白	
白白力力	白白力力	白白力力	
白脱	白脱	白脫	
白塔塔	白塔塔	白塔塔	
白煠蛋	白煠蛋	白煠蛋	
白鴿	白鸽	白鴿	
白鴿籠	白鸽笼	白鴿籠	
白藥	白药	白藥	
白木耳	白木耳	白木耳	
白玉蘭	白玉兰	白玉蘭	
白鐵	白铁	白鐵	
白鐵匠	白铁匠	白鐵匠	
白日撞	白日撞	白日撞	
拔	拔	拔	
拔	拔	拔	
拔麵湯	拔面汤	拔麪湯	
拔草	拔草	拔草	
拔苗頭	拔苗头	拔苗頭	
拔火罐	拔火罐	拔火罐	
拔河	拔河	拔河	
拔長	拔长	拔長	
祓秋	祓秋	祓秋	
鼻頭	鼻头	鼻頭	
鼻頭水	鼻头水	鼻頭水	
鼻頭毛	鼻头毛	鼻頭毛	
鼻頭屙	鼻头屙	鼻頭屙	
鼻頭梁	鼻头梁	鼻頭樑	
鼻頭管	鼻头管	鼻頭管	
鼻頭管塞煞	鼻头管塞煞	鼻頭管塞煞	
鼻頭管洞眼	鼻头管洞眼	鼻頭管洞眼	
鼻頭管尖頭	鼻头管尖头	鼻頭管尖頭	
鼻頭靈光	鼻头灵光	鼻頭靈光	
鼻頭紅	鼻头红	鼻頭紅	
鼻頭紅血	鼻头红血	鼻頭紅血	
末	末	末	
末都囡	末都囡	末都囡	
末都兒子	末都儿子	末都兒子	
末末腐	末末腐	末末腐	
末腳	末脚	末腳	
末腳名	末脚名	末腳名	
没	没	沒	
没嘴没得	没嘴没得	沒嘴沒得	
没搭○頭	没搭○头	沒搭○頭	
没克没克	没克没克	沒克沒克	
茉莉花	茉莉花	茉莉花	
𢫦	𢫦	𢫦	
脈息	脉息	脈息	
麥	麦	麥	
麥稈	麦秆	麥稈	
麥搗孔	麦捣孔	麥搗孔	
麥水孔	麦水孔	麥水孔	
麥搗子頭	麦捣子头	麥搗子頭	
麥摐	麦𪭢	麥摐	
麥培○	麦培○	麥培○	
麥芒	麦芒	麥芒	
麥根頭	麦根头	麥根頭	
麥根頭	麦根头	麥根頭	
默書	默书	默書	
襪	袜	襪	
襪帶	袜带	襪帶	
襪套頭	袜套头	襪套頭	
襪船	袜船	襪船	
襪撑	袜撑	襪撐	
襪筒	袜筒	襪筒	
弗	弗	弗	
弗二弗三	弗二弗三	弗二弗三	
弗打記頭	弗打记头	弗打記頭	
弗上弗落	弗上弗落	弗上弗落	
弗尷弗尬	弗尴弗尬	弗尷弗尬	
弗燥弗濕	弗燥弗湿	弗燥弗溼	
弗結	弗结	弗結	
弗結咋是咋	弗结咋是咋	弗結咋是咋	
法國梧桐	法国梧桐	法國梧桐	
法國帽	法国帽	法國帽	
發	发	發	
發癡	发痴	發癡	
發水	发水	發水	
發霧露	发雾露	發霧露	
發喥	发喥	發喥	
發喥性	发喥性	發喥性	
發爐子	发炉子	發爐子	
發買○柴○病	发买○柴○病	發買○柴○病	
發冷熱病	发冷热病	發冷熱病	
發大興	发大兴	發大興	
發酵	发酵	發酵	
發酵粉	发酵粉	發酵粉	
發痧氣	发痧气	發痧氣	
發票	发票	發票	
發呆勁	发呆劲	發呆勁	
發酒瘋	发酒疯	發酒瘋	
發酒勁	发酒劲	發酒勁	
發寒熱	发寒热	發寒熱	
發棵	发棵	發棵	
發冷	发冷	發冷	
發横財	发横财	發橫財	
發情	发情	發情	
發心	发心	發心	
發身	发身	發身	
發嗝	发嗝	發嗝	
發帖子	发帖子	發帖子	
發𩔈	发𩔈	發𩔈	
發𩔈泥螺	发𩔈泥螺	發𩔈泥螺	
發熱昏	发热昏	發熱昏	
發食	发食	發食	
發出	发出	發出	
髮腳	发脚	髮腳	
勿	勿	勿	
勿敢當	勿敢当	勿敢當	
勿依	勿依	勿依	
勿大	勿大	勿大	
勿咋	勿咋	勿咋	
勿捨得	勿舍得	勿捨得	
…勿來	…勿来	…勿來	
勿在内	勿在内	勿在內	
勿入料	勿入料	勿入料	
勿上課	勿上课	勿上課	
勿對	勿对	勿對	
勿做肉	勿做肉	勿做肉	
勿錯	勿错	勿錯	
…勿過	…勿过	…勿過	
勿生好心	勿生好心	勿生好心	
勿長毛	勿长毛	勿長毛	
…勿相似	…勿相似	…勿相似	
…勿樣	…勿样	…勿樣	
…勿相樣	…勿相样	…勿相樣	
…勿相相	…勿相相	…勿相相	
勿管賬	勿管账	勿管賬	
勿論	勿论	勿論	
勿肯歇	勿肯歇	勿肯歇	
勿認得	勿认得	勿認得	
勿…勿…	勿…勿…	勿…勿…	
…勿得	…勿得	…勿得	
勿得了	勿得了	勿得了	
勿服	勿服	勿服	
勿結○	勿结○	勿結○	
勿怯氣	勿怯气	勿怯氣	
勿及○港○	勿及○港○	勿及○港○	
佛	佛	佛	
佛手	佛手	佛手	
佛堂	佛堂	佛堂	
物證	物证	物證	
罰願	罚愿	罰願	
罰鈔票	罚钞票	罰鈔票	
罰咒	罚咒	罰咒	
得	得	得	
得斯	得斯	得斯	
得○漫○	得○漫○	得○漫○	
得人惜	得人惜	得人惜	
得寵	得宠	得寵	
得法	得法	得法	
得得	得得	得得	
掇	掇	掇	
搭	搭	搭	
躲○	躲○	躲○	
等○	等○	等○	
底○	底○	底○	
搭子	搭子	搭子	
搭仔	搭仔	搭仔	
搭肝	搭肝	搭肝	
搭界	搭界	搭界	
搭牢	搭牢	搭牢	
搭架子	搭架子	搭架子	
搭橋	搭桥	搭橋	
搭班	搭班	搭班	
搭襻	搭襻	搭襻	
搭手	搭手	搭手	
搭對	搭对	搭對	
搭伙精	搭伙精	搭夥精	
搭漿	搭浆	搭漿	
搭搭漿	搭搭浆	搭搭漿	
搭檔	搭档	搭檔	
搭脈	搭脉	搭脈	
搭積木	搭积木	搭積木	
嗒	嗒	嗒	
溚溚渧	溚溚渧	溚溚渧	
𢱕𢱕動	𢱕𢱕动	𢱕𢱕動	
秃頂	秃顶	禿頂	
忒	忒	忒	
忒	忒	忒	
沓	沓	沓	
脱	脱	脫	
脱皮	脱皮	脫皮	
脱底蛇籮	脱底蛇箩	脫底蛇籮	
脱卯	脱卯	脫卯	
脱絞	脱绞	脫絞	
脱班	脱班	脫班	
脱懶	脱懒	脫懶	
脱頭	脱头	脫頭	
脱空	脱空	脫空	
脱隔	脱隔	脫隔	
脱力	脱力	脫力	
塔○	塔○	塔○	
塔古菜	塔古菜	塔古菜	
塔松	塔松	塔鬆	
塌	塌	塌	
塌鼻頭管	塌鼻头管	塌鼻頭管	
塌塌𤿏	塌塌𤿏	塌塌𤿏	
搨	搨	搨	
搨大餅	搨大饼	搨大餅	
搨大餅	搨大饼	搨大餅	
搨襪底	搨袜底	搨襪底	
沓	沓	沓	
沓	沓	沓	
突	突	突	
特爲	特为	特爲	
特特意	特特意	特特意	
特意	特意	特意	
特猛	特猛	特猛	
特戇	特戆	特戇	
特特意意	特特意意	特特意意	
涾涾渧	涾涾渧	涾涾渧	
涾涾爛渧	涾涾烂渧	涾涾爛渧	
涾涾滾	涾涾滚	涾涾滾	
達○餡子	达○馅子	達○餡子	
踏	踏	踏	
踏斗	踏斗	踏鬥	
踏方步	踏方步	踏方步	
踏牀	踏床	踏牀	
踏腳	踏脚	踏腳	
衲	衲	衲	
衲爿	衲爿	衲爿	
衲頭	衲头	衲頭	
倷	倷	倷	
倷兩人	倷两人	倷兩人	
倷個	倷个	倷個	
肋排骨	肋排骨	肋排骨	
肋條	肋条	肋條	
肋膈肢下	肋膈肢下	肋膈肢下	
肋膈肢下毛	肋膈肢下毛	肋膈肢下毛	
迾	迾	迾	
迾板	迾板	迾板	
迾栅	迾栅	迾柵	
捋	捋	捋	
勒	勒	勒	
勒	勒	勒	
勒眼	勒眼	勒眼	
勒渠	勒渠	勒渠	
…勒過	…勒过	…勒過	
…勒樣	…勒样	…勒樣	
…勒相樣	…勒相样	…勒相樣	
…勒相相	…勒相相	…勒相相	
辣	辣	辣	
辣○	辣○	辣○	
辣○子	辣○子	辣○子	
辣椒粉	辣椒粉	辣椒粉	
辣茄	辣茄	辣茄	
辣椒	辣椒	辣椒	
辣手	辣手	辣手	
辣油	辣油	辣油	
辣呵呵	辣呵呵	辣呵呵	
辣麻麻	辣麻麻	辣麻麻	
辣火	辣火	辣火	
辣火醬	辣火酱	辣火醬	
辣醬油	辣酱油	辣醬油	
辣白菜	辣白菜	辣白菜	
辣辣茄	辣辣茄	辣辣茄	
邋遢	邋遢	邋遢	
邋裏邋遢	邋里邋遢	邋里邋遢	
臘梅	腊梅	臘梅	
臘腸	腊肠	臘腸	
臘○塞○	腊○塞○	臘○塞○	
臘肉	腊肉	臘肉	
蠟黃	蜡黄	蠟黃	
蠟蠟黃	蜡蜡黄	蠟蠟黃	
蠟燭包	蜡烛包	蠟燭包	
蠟燭巴釘	蜡烛巴钉	蠟燭巴釘	
蠟燭臺	蜡烛台	蠟燭臺	
蠟燭頭	蜡烛头	蠟燭頭	
蠟酒壺	蜡酒壶	蠟酒壺	
鑞匠	镴匠	鑞匠	
鑞○白	镴○白	鑞○白	
扎○	扎○	扎○	
扎注○	扎注○	扎注○	
扎面子	扎面子	扎面子	
扎臍帶	扎脐带	扎臍帶	
扎奶	扎奶	扎奶	
扎扮	扎扮	扎扮	
扎鈎	扎钩	扎鉤	
扎硬	扎硬	扎硬	
扎○秧子	扎○秧子	扎○秧子	
扎壯	扎壮	扎壯	
扎括	扎括	扎括	
卒○格	卒○格	卒○格	
卒○格爛眼	卒○格烂眼	卒○格爛眼	
咂	咂	咂	
隻	只	只	
側	侧	側	
側格楞敦	侧格楞敦	側格楞敦	
側刀旁	侧刀旁	側刀旁	
側轉	侧转	側轉	
側楞睏	侧楞困	側楞困	
摘	摘	摘	
叉燒	叉烧	叉燒	
尺	尺	尺	
尺四鑊	尺四镬	尺四鑊	
尺板	尺板	尺板	
尺八磨	尺八磨	尺八磨	
尺八鑊	尺八镬	尺八鑊	
尺六鑊	尺六镬	尺六鑊	
赤佬	赤佬	赤佬	
赤豆	赤豆	赤豆	
赤豆糕	赤豆糕	赤豆糕	
拆爛屙	拆烂屙	拆爛屙	
拆短	拆短	拆短	
拆亂話	拆乱话	拆亂話	
拆賬做	拆账做	拆賬做	
拆空	拆空	拆空	
拆搭	拆搭	拆搭	
拆骨頭	拆骨头	拆骨頭	
珿齊	珿齐	珿齊	
斬斬齊	斩斩齐	斬斬齊	
珿珿齊	珿珿齐	珿珿齊	
珿斬斯齊	珿斩斯齐	珿斬斯齊	
珿珿斯齊	珿珿斯齐	珿珿斯齊	
測字	测字	測字	
測字先生	测字先生	測字先生	
測驗	测验	測驗	
插嘴	插嘴	插嘴	
插地藏香	插地藏香	插地藏香	
插銷	插销	插銷	
插話	插话	插話	
插座	插座	插座	
插頭	插头	插頭	
插撲	插扑	插撲	
插秧	插秧	插秧	
插蠟燭	插蜡烛	插蠟燭	
撮	撮	撮	
撮子	撮子	撮子	
撮紙團	撮纸团	撮紙團	
撮便宜	撮便宜	撮便宜	
撮便宜貨	撮便宜货	撮便宜貨	
撮棉花	撮棉花	撮棉花	
撮記引記	撮记引记	撮記引記	
撮外快	撮外快	撮外快	
撮花提簍	撮花提篓	撮花提簍	
撮來依到	撮来依到	撮來依到	
撮頭	撮头	撮頭	
撮牛屙	撮牛屙	撮牛屙	
撮引	撮引	撮引	
撮白失	撮白失	撮白失	
擦○紫	擦○紫	擦○紫	
擦米	擦米	擦米	
擦○烏	擦○乌	擦○烏	
擦○擦○烏	擦○擦○乌	擦○擦○烏	
擦牙子	擦牙子	擦牙子	
擦背	擦背	擦背	
擦○暗	擦○暗	擦○暗	
擦○擦○暗	擦○擦○暗	擦○擦○暗	
墨擦○暗	墨擦○暗	墨擦○暗	
墨墨暗	墨墨暗	墨墨暗	
墨擦○斯暗	墨擦○斯暗	墨擦○斯暗	
墨擦○地暗	墨擦○地暗	墨擦○地暗	
墨裏擦○暗	墨里擦○暗	墨裏擦○暗	
墨地擦○暗	墨地擦○暗	墨地擦○暗	
墨裏墨暗	墨里墨暗	墨裏墨暗	
擦○暗薄龍	擦○暗薄龙	擦○暗薄龍	
擦煞	擦煞	擦煞	
擦○黑	擦○黑	擦○黑	
擦○擦○黑	擦○擦○黑	擦○擦○黑	
墨擦○黑	墨擦○黑	墨擦○黑	
墨墨黑	墨墨黑	墨墨黑	
擦○黑泥藍	擦○黑泥蓝	擦○黑泥藍	
墨擦○鐵黑	墨擦○铁黑	墨擦○鐵黑	
墨擦○地黑	墨擦○地黑	墨擦○地黑	
墨地擦○黑	墨地擦○黑	墨地擦○黑	
墨裏墨黑	墨里墨黑	墨裏墨黑	
簇刮新	簇刮新	簇刮新	
簇刮勒新	簇刮勒新	簇刮勒新	
簇刮斯新	簇刮斯新	簇刮斯新	
檫樹	檫树	檫樹	
宅基地	宅基地	宅基地	
捽	捽	捽	
色○	色○	色○	
色子	色子	色子	
色○水	色○水	色○水	
色○色○澾澾	色○色○㳠㳠	色○色○澾澾	
色○雪	色○雪	色○雪	
眨	眨	眨	
𥈊	𥈊	𥈊	
殺豬屠	杀猪屠	殺豬屠	
殺坯	杀坯	殺坯	
殺頭	杀头	殺頭	
塞○	塞○	塞○	
塞飯	塞饭	塞飯	
塞飯榔頭	塞饭榔头	塞飯榔頭	
塞暗亮頭	塞暗亮头	塞暗亮頭	
塞銅鈿	塞铜钿	塞銅鈿	
塞頭	塞头	塞頭	
煞	煞	煞	
煞	煞	煞	
煞快	煞快	煞快	
煞死	煞死	煞死	
煞人	煞人	煞人	
煞扣	煞扣	煞扣	
煞清爽	煞清爽	煞清爽	
煞煞清爽	煞煞清爽	煞煞清爽	
煞辣清爽	煞辣清爽	煞辣清爽	
煞辣斯清爽	煞辣斯清爽	煞辣斯清爽	
煞性	煞性	煞性	
煞性健	煞性健	煞性健	
煞○拱○	煞○拱○	煞○拱○	
煞潑	煞泼	煞潑	
煞辣	煞辣	煞辣	
煞納	煞纳	煞納	
煞煞口	煞煞口	煞煞口	
煞格	煞格	煞格	
煞縛	煞缚	煞縛	
煞煞格格	煞煞格格	煞煞格格	
煞煞縛縛	煞煞缚缚	煞煞縛縛	
啬比比	啬比比	嗇比比	
蝨	虱	蝨	
蝨末鬼	虱末鬼	蝨末鬼	
蝨末老鬼	虱末老鬼	蝨末老鬼	
澀口	涩口	澀口	
澀肯頭	涩肯头	澀肯頭	
澀肯肯	涩肯肯	澀肯肯	
澀格格	涩格格	澀格格	
𧼰時裏	𧼰时里	𧼰時裏	
𧼰時	𧼰时	𧼰時	
石子	石子	石子	
石庫門	石库门	石庫門	
石庫牆門	石库墙门	石庫牆門	
石階沿	石阶沿	石階沿	
石蟹	石蟹	石蟹	
石蛋子	石蛋子	石蛋子	
石卵子	石卵子	石卵子	
石榴	石榴	石榴	
石灰	石灰	石灰	
石磨	石磨	石磨	
石頭	石头	石頭	
石硬	石硬	石硬	
石石硬	石石硬	石石硬	
石骨硬	石骨硬	石骨硬	
石骨鐵硬	石骨铁硬	石骨鐵硬	
石匠	石匠	石匠	
石岩	石岩	石巖	
閘○出	闸○出	閘○出	
賊	贼	賊	
賊苦出	贼苦出	賊苦出	
賊苦	贼苦	賊苦	
賊賊苦	贼贼苦	賊賊苦	
賊老頭	贼老头	賊老頭	
賊話	贼话	賊話	
賊臭	贼臭	賊臭	
賊賊臭	贼贼臭	賊賊臭	
賊坯	贼坯	賊坯	
賊窩家	贼窝家	賊窩家	
賊頭狗腦	贼头狗脑	賊頭狗腦	
賊腔	贼腔	賊腔	
賊笨	贼笨	賊笨	
賊賊笨	贼贼笨	賊賊笨	
賊勒兒子	贼勒儿子	賊勒兒子	
賊骨頭	贼骨头	賊骨頭	
賊嘸狗樣	贼呒狗样	賊嘸狗樣	
鍘刀	铡刀	鍘刀	
雜格愣敦	杂格愣敦	雜格愣敦	
𧾁	𧾁	𧾁	
夾	夹	夾	
夾裏面爿	夹里面爿	夾裏面爿	
夾大衣	夹大衣	夾大衣	
夾襖	夹袄	夾襖	
夾衫	夹衫	夾衫	
夾䩍白	夹䩍白	夾䩍白	
夾籮	夹箩	夾籮	
夾生	夹生	夾生	
夾生飯	夹生饭	夾生飯	
夾生米飯	夹生米饭	夾生米飯	
夾心餅乾	夹心饼干	夾心餅乾	
夾腳縫	夹脚缝	夾腳縫	
疙嘴疙得	疙嘴疙得	疙嘴疙得	
疙裏疙得	疙里疙得	疙裏疙得	
疙瘩	疙瘩	疙瘩	
革○着	革○着	革○着	
䀫	䀫	䀫	
格	格	格	
格○	格○	格○	
格步階	格步阶	格步階	
格步路梯	格步路梯	格步路梯	
格貌	格貌	格貌	
格貌介	格貌介	格貌介	
格相貌	格相貌	格相貌	
格相貌介	格相貌介	格相貌介	
格貌介	格貌介	格貌介	
格相貌介	格相貌介	格相貌介	
格○算	格○算	格○算	
格○頭格○腦	格○头格○脑	格○頭格○腦	
格楞敦	格楞敦	格楞敦	
格星	格星	格星	
格末	格末	格末	
格勒	格勒	格勒	
格栅	格栅	格柵	
割	割	割	
割螄螺	割蛳螺	割螄螺	
割稻	割稻	割稻	
割稻時	割稻时	割稻時	
割稻人客	割稻人客	割稻人客	
割早稻	割早稻	割早稻	
割晚青	割晚青	割晚青	
割晚稻	割晚稻	割晚稻	
割夜稻	割夜稻	割夜稻	
割青草	割青草	割青草	
割麥	割麦	割麥	
蛤皮	蛤皮	蛤皮	
蛤底泥	蛤底泥	蛤底泥	
蛤蜊油	蛤蜊油	蛤蜊油	
蚌殼油	蚌壳油	蚌殼油	
蛤蚆	蛤蚆	蛤蚆	
隔○	隔○	隔○	
隔手賬	隔手账	隔手賬	
隔火牆	隔火墙	隔火牆	
隔○進隔○出	隔○进隔○出	隔○進隔○出	
隔壁	隔壁	隔壁	
隔壁鄰舍	隔壁邻舍	隔壁鄰舍	
隔壁叔婆	隔壁叔婆	隔壁叔婆	
隔○舌頭	隔○舌头	隔○舌頭	
隔○出	隔○出	隔○出	
塥泥	塥泥	塥泥	
槅子	槅子	槅子	
㾸𤶁	㾸𤶁	㾸𤶁	
克舵	克舵	克舵	
刻	刻	刻	
刻忖	刻忖	刻忖	
咳嗽	咳嗽	咳嗽	
客	客	客	
客邊	客边	客邊	
客車	客车	客車	
客棧	客栈	客棧	
客堂間	客堂间	客堂間	
剋落	克落	剋落	
掐	掐	掐	
掐算	掐算	掐算	
掐膿	掐脓	掐膿	
揢	揢	揢	
磕開	磕开	磕開	
磕煞	磕煞	磕煞	
磕跌	磕跌	磕跌	
磕	磕	磕	
磕頭蟲	磕头虫	磕頭蟲	
瞌𥅻	瞌𥅻	瞌𥅻	
瞌𥅻面貌	瞌𥅻面貌	瞌𥅻面貌	
瞌𥅻懵懂	瞌𥅻懵懂	瞌𥅻懵懂	
軋	轧	軋	
軋米	轧米	軋米	
軋起軋倒	轧起轧倒	軋起軋倒	
軋鉗	轧钳	軋鉗	
軋刀	轧刀	軋刀	
軋道	轧道	軋道	
軋稻	轧稻	軋稻	
軋牢	轧牢	軋牢	
軋苗頭	轧苗头	軋苗頭	
軋花被	轧花被	軋花被	
軋花子	轧花子	軋花子	
軋頭寸	轧头寸	軋頭寸	
軋朋友	轧朋友	軋朋友	
軋賬	轧账	軋賬	
軋姘頭	轧姘头	軋姘頭	
軋平	轧平	軋平	
軋穀	轧谷	軋谷	
軋直	轧直	軋直	
軋一腳	轧一脚	軋一腳	
軋出	轧出	軋出	
杌	杌	杌	
杌頭	杌头	杌頭	
杌頭	杌头	杌頭	
額角頭	额角头	額角頭	
齾	𫜰	齾	
黑	黑	黑	
黑的剝落	黑的剥落	黑的剝落	
黑鐵撲落	黑铁扑落	黑鐵撲落	
黑兹兹	黑兹兹	黑茲茲	
黑子	黑子	黑子	
黑市	黑市	黑市	
黑無常	黑无常	黑無常	
黑棗	黑枣	黑棗	
黑麻粉	黑麻粉	黑麻粉	
黑洋酥	黑洋酥	黑洋酥	
黑叉	黑叉	黑叉	
黑板	黑板	黑板	
黑炭	黑炭	黑炭	
黑藍	黑蓝	黑藍	
黑油筒	黑油筒	黑油筒	
黑油菜	黑油菜	黑油菜	
黑油綠	黑油绿	黑油綠	
黑清老早	黑清老早	黑清老早	
黑心	黑心	黑心	
黑木耳	黑木耳	黑木耳	
黑出出	黑出出	黑出出	
瞎三話四	瞎三话四	瞎三話四	
瞎眼	瞎眼	瞎眼	
瞎講相	瞎讲相	瞎講相	
嚇	吓	嚇	
嚇老老	吓老老	嚇老老	
嚇勢勢	吓势势	嚇勢勢	
嚇嫩	吓嫩	嚇嫩	
嚇嚇嫩	吓吓嫩	嚇嚇嫩	
嚇刮嫩	吓刮嫩	嚇刮嫩	
嚇刮斯嫩	吓刮斯嫩	嚇刮斯嫩	
嚇人倒怪	吓人倒怪	嚇人倒怪	
嚇煞	吓煞	嚇煞	
合撲	合扑	合撲	
狭	狭	狹	
狹倰倰	狭倰倰	狹倰倰	
盒	盒	盒	
厄○掉	厄○掉	厄○掉	
厄○伏○氣	厄○伏○气	厄○伏○氣	
厄○伏○伏○	厄○伏○伏○	厄○伏○伏○	
厄○伏○幾糟	厄○伏○几糟	厄○伏○幾糟	
阿	阿	阿	
阿弟	阿弟	阿弟	
阿裏	阿里	阿里	
阿裏眼	阿里眼	阿里眼	
阿裏一眼	阿里一眼	阿里一眼	
阿裏個	阿里个	阿里個	
阿裏一個	阿里一个	阿里一個	
阿裏個	阿里个	阿里個	
阿裏一個	阿里一个	阿里一個	
阿姊	阿姊	阿姊	
阿姨	阿姨	阿姨	
阿姑	阿姑	阿姑	
阿姑姪子	阿姑侄子	阿姑侄子	
阿太	阿太	阿太	
阿爹	阿爹	阿爹	
阿姐	阿姐	阿姐	
阿姐屄	阿姐屄	阿姐屄	
阿姐式	阿姐式	阿姐式	
阿姐式	阿姐式	阿姐式	
阿爺	阿爷	阿爺	
阿爺孫子	阿爷孙子	阿爺孫子	
阿嫂	阿嫂	阿嫂	
阿小	阿小	阿小	
阿難死	阿难死	阿難死	
阿舅	阿舅	阿舅	
阿囡	阿囡	阿囡	
阿妹	阿妹	阿妹	
阿婆	阿婆	阿婆	
阿大	阿大	阿大	
阿二	阿二	阿二	
阿三	阿三	阿三	
阿四	阿四	阿四	
阿五	阿五	阿五	
阿六	阿六	阿六	
阿哥	阿哥	阿哥	
阿伯	阿伯	阿伯	
阿娘	阿娘	阿孃	
阿鄉	阿乡	阿鄉	
阿防	阿防	阿防	
阿講	阿讲	阿講	
阿講	阿讲	阿講	
阿戇	阿戆	阿戇	
阿伴	阿伴	阿伴	
阿奶	阿奶	阿奶	
阿嬸	阿婶	阿嬸	
阿叔	阿叔	阿叔	
阿叔姪子	阿叔侄子	阿叔侄子	
阿公老頭	阿公老头	阿公老頭	
阿公	阿公	阿公	
阿伯	阿伯	阿伯	
阿拉	阿拉	阿拉	
阿拉兩人	阿拉两人	阿拉兩人	
阿木林	阿木林	阿木林	
阿啥	阿啥	阿啥	
阿啥	阿啥	阿啥	
阿啥幹	阿啥干	阿啥幹	
阿啥幹	阿啥干	阿啥幹	
阿啥體	阿啥体	阿啥體	
阿啥體	阿啥体	阿啥體	
阿屈死	阿屈死	阿屈死	
阿育王寺	阿育王寺	阿育王寺	
阿姪	阿侄	阿侄	
押去	押去	押去	
押寶	押宝	押寶	
壓寶	压宝	壓寶	
押頭	押头	押頭	
押房子	押房子	押房子	
押金	押金	押金	
鴨尿臭	鸭尿臭	鴨尿臭	
鴨廐間	鸭厩间	鴨廄間	
鴨泥	鸭泥	鴨泥	
鴨蛋	鸭蛋	鴨蛋	
鴨蛋子	鸭蛋子	鴨蛋子	
轉蛋青	转蛋青	轉蛋青	
鴨肫	鸭肫	鴨肫	
鴨肫乾	鸭肫干	鴨肫幹	
鴨舌頭	鸭舌头	鴨舌頭	
鴨舌頭帽	鸭舌头帽	鴨舌頭帽	
鴨血	鸭血	鴨血	
壓進	压进	壓進	
壓末	压末	壓末	
壓煞	压煞	壓煞	
壓末名	压末名	壓末名	
壓煞名	压煞名	壓煞名	
壓髮帽	压发帽	壓發帽	
壓勿殺	压勿杀	壓勿殺	
帖	帖	帖	
帖子	帖子	帖子	
貼	贴	貼	
貼水	贴水	貼水	
貼紕	贴纰	貼紕	
貼袋	贴袋	貼袋	
貼當中	贴当中	貼當中	
貼堂房	贴堂房	貼堂房	
貼心	贴心	貼心	
貼隔壁	贴隔壁	貼隔壁	
碟子	碟子	碟子	
叠叠炮	叠叠炮	疊疊炮	
掠	掠	掠	
甲	甲	甲	
甲魚	甲鱼	甲魚	
莢	荚	莢	
雀子斑	雀子斑	雀子斑	
着棋	着棋	着棋	
着棋子	着棋子	着棋子	
着衣鏡	着衣镜	着衣鏡	
着顏色	着颜色	着顏色	
腳	脚	腳	
腳水	脚水	腳水	
腳面	脚面	腳面	
腳板面	脚板面	腳板面	
腳底下	脚底下	腳底下	
腳底心	脚底心	腳底心	
腳蹄	脚蹄	腳蹄	
腳尖	脚尖	腳尖	
腳泥螺	脚泥螺	腳泥螺	
腳末泥螺	脚末泥螺	腳末泥螺	
腳夫	脚夫	腳伕	
腳班	脚班	腳班	
腳爪	脚爪	腳爪	
子	子	子	
腳高腳低	脚高脚低	腳高腳低	
腳銬	脚铐	腳銬	
腳絞仔	脚绞仔	腳絞仔	
腳凹	脚凹	腳凹	
腳紗頭	脚纱头	腳紗頭	
腳搲船	脚搲船	腳搲船	
腳橋	脚桥	腳橋	
腳板	脚板	腳板	
腳底板	脚底板	腳底板	
腳䯊頭	脚䯊头	腳䯊頭	
腳頭	脚头	腳頭	
腳後跟	脚后跟	腳後跟	
腳碰腳	脚碰脚	腳碰腳	
腳娘肚	脚娘肚	腳娘肚	
腳上腳落	脚上脚落	腳上腳落	
腳筋	脚筋	腳筋	
腳筋奔斷	脚筋奔断	腳筋奔斷	
腳底奔穿	脚底奔穿	腳底奔穿	
腳勁	脚劲	腳勁	
腳印	脚印	腳印	
腳桶	脚桶	腳桶	
腳盆	脚盆	腳盆	
腳魄	脚魄	腳魄	
腳踏車	脚踏车	腳踏車	
腳色	脚色	腳色	
腳煞	脚煞	腳煞	
腳夾缝	脚夹缝	腳夾縫	
腳罅縫	脚罅缝	腳罅縫	
腳甲末頭	脚甲末头	腳甲末頭	
腳末頭	脚末头	腳末頭	
腳甲掐	脚甲掐	腳甲掐	
腳骨	脚骨	腳骨	
腳骨抖抖	脚骨抖抖	腳骨抖抖	
腳骨笋	脚骨笋	腳骨筍	
腳膊○絡○頭	脚膊○络○头	腳膊○絡○頭	
腳盤○路○頭	脚盘○路○头	腳盤○路○頭	
腳㬹子頭	脚㬹子头	腳㬹子頭	
腳㬹	脚㬹	腳㬹	
腳鐲	脚镯	腳鐲	
𢜭力	𢜭力	𢜭力	
箬殼	箬壳	箬殼	
鰙鰨	鰙鳎	鰙鰨	
鰙鰨魚	鰙鳎鱼	鰙鰨魚	
削○	削○	削○	
削○冬冬	削○冬冬	削○鼕鼕	
削地𡍲	削地𡍲	削地𡍲	
削骨臉	削骨脸	削骨臉	
嚼麥糕	嚼麦糕	嚼麥糕	
嚼勿動	嚼勿动	嚼勿動	
嚼勿落	嚼勿落	嚼勿落	
藥水肥皂	药水肥皂	藥水肥皂	
藥店	药店	藥店	
藥碾子	药碾子	藥碾子	
藥膏	药膏	藥膏	
藥沙罐	药沙罐	藥沙罐	
藥房	药房	藥房	
藥行	药行	藥行	
藥丸	药丸	藥丸	
藥丸	药丸	藥丸	
藥粉	药粉	藥粉	
藥戥子	药戥子	藥戥子	
藥芹	药芹	藥芹	
藥腥氣	药腥气	藥腥氣	
鑰匙	钥匙	鑰匙	
刮	刮	刮	
刮斯	刮斯	刮斯	
刮水缸腳	刮水缸脚	刮水缸腳	
刮皮	刮皮	刮皮	
刮皮鬼	刮皮鬼	刮皮鬼	
刮氣	刮气	刮氣	
刮刀布	刮刀布	刮刀布	
刮痧	刮痧	刮痧	
刮牙鬚	刮牙须	刮牙須	
刮板	刮板	刮板	
刮得	刮得	颳得	
刮刮	刮刮	刮刮	
刮刮抖	刮刮抖	刮刮抖	
刮結	刮结	刮結	
骨灰箱	骨灰箱	骨灰箱	
骨頭	骨头	骨頭	
骨頭腦髄	骨头脑髄	骨頭腦髄	
骨僵	骨僵	骨僵	
骨生	骨生	骨生	
骨敦	骨敦	骨敦	
骨挺	骨挺	骨挺	
骨骨挺	骨骨挺	骨骨挺	
筆筆挺	笔笔挺	筆筆挺	
骨針	骨针	骨針	
骨勒斯圓	骨勒斯圆	骨勒斯圓	
骨篤○	骨笃○	骨篤○	
骨篤翘	骨笃翘	骨篤翹	
骨碌碌	骨碌碌	骨碌碌	
骨勒勒	骨勒勒	骨勒勒	
骨直	骨直	骨直	
骨骨直	骨骨直	骨骨直	
筆筆直	笔笔直	筆筆直	
筆篤斯直	笔笃斯直	筆篤斯直	
摑耳光	掴耳光	摑耳光	
闊	阔	闊	
闊扁毛豆	阔扁毛豆	闊扁毛豆	
闊拉柴	阔拉柴	闊拉柴	
☐	☐	☐	
甩	甩	甩	
思流星	思流星	思流星	
豁	豁	豁	
豁吹○吹○	豁吹○吹○	豁吹○吹○	
豁水	豁水	豁水	
豁邊	豁边	豁邊	
豁拳	豁拳	豁拳	
豁開	豁开	豁開	
豁大大	豁大大	豁大大	
豁朵朵	豁朵朵	豁朵朵	
豁辣面	豁辣面	豁辣面	
豁出	豁出	豁出	
豁出木屐	豁出木屐	豁出木屐	
囫圇	囫囵	囫圇	
活被	活被	活被	
活氽活滾	活氽活滚	活氽活滾	
活猻	活狲	活猻	
活猻屁股	活狲屁股	活猻屁股	
活靈	活灵	活靈	
活靈嚇出	活灵吓出	活靈嚇出	
活龍	活龙	活龍	
活龍活現	活龙活现	活龍活現	
活脱塑子	活脱塑子	活脫塑子	
活脱過數	活脱过数	活脫過數	
活脱印過	活脱印过	活脫印過	
活腳	活脚	活腳	
活絡	活络	活絡	
活裏活絡	活里活络	活裏活絡	
活出離	活出离	活出離	
活結	活结	活結	
活股結	活股结	活股結	
滑	滑	滑	
滑子	滑子	滑子	
滑稽戲	滑稽戏	滑稽戲	
滑奇奇	滑奇奇	滑奇奇	
滑頭	滑头	滑頭	
滑頭滑腦	滑头滑脑	滑頭滑腦	
滑頭碼子	滑头码子	滑頭碼子	
滑腸	滑肠	滑腸	
滑相	滑相	滑相	
滑脱精光	滑脱精光	滑脫精光	
滑澾精光	滑㳠精光	滑澾精光	
滑澾澾	滑㳠㳠	滑澾澾	
劃帳	划帐	劃帳	
𣝗	𣝗	𣝗	
挖	挖	挖	
挖耳	挖耳	挖耳	
挖耳	挖耳	挖耳	
挖○佬佬	挖○佬佬	挖○佬佬	
挖袋	挖袋	挖袋	
挖打	挖打	挖打	
挖井	挖井	挖井	
挖壁打洞	挖壁打洞	挖壁打洞	
殟塞	殟塞	殟塞	
䩊	䩊	䩊	
𩑦	𩑦	𩑦	
卜課	卜课	卜課	
卜卦	卜卦	卜卦	
卜課先生	卜课先生	卜課先生	
北斗星	北斗星	北斗星	
北半邊	北半边	北半邊	
剝	剥	剝	
剝皮大烤	剥皮大烤	剝皮大烤	
剝剝	剥剥	剝剝	
博	博	博	
駁	驳	駁	
駁船	驳船	駁船	
魄屍	魄尸	魄屍	
撲	扑	撲	
撲腦殻	扑脑壳	撲腦殼	
撲蓋頭	扑盖头	撲蓋頭	
撲粉	扑粉	撲粉	
撲粉頭	扑粉头	撲粉頭	
撲克	扑克	撲克	
撲克牌	扑克牌	撲克牌	
撲克牌	扑克牌	撲克牌	
撲落	扑落	撲落	
𩔈	𩔈	𩔈	
醭	醭	醭	
伏	伏	伏	
雹子	雹子	雹子	
薄	薄	薄	
薄刀	薄刀	薄刀	
薄脆	薄脆	薄脆	
薄耘耘	薄耘耘	薄耘耘	
薄薄個	薄薄个	薄薄個	
薄粥	薄粥	薄粥	
薄粥湯	薄粥汤	薄粥湯	
木	木	木	
木篤篤	木笃笃	木篤篤	
木性性	木性性	木性性	
木直直	木直直	木直直	
木冬冬	木冬冬	木鼕鼕	
木梳	木梳	木梳	
木知木覺	木知木觉	木知木覺	
木而覺知	木而觉知	木而覺知	
木柿	木柿	木柿	
木蓮	木莲	木蓮	
木蓮藤	木莲藤	木蓮藤	
木器店	木器店	木器店	
木乎乎	木乎乎	木乎乎	
木佬佬	木佬佬	木佬佬	
木馬	木马	木馬	
蠻矮凳	蛮矮凳	蠻矮凳	
木瓜	木瓜	木瓜	
木家	木家	木家	
木材行	木材行	木材行	
木炭	木炭	木炭	
木手木腳	木手木脚	木手木腳	
木大	木大	木大	
木倭樹	木倭树	木倭樹	
木頭人案	木头人案	木頭人案	
木頭木腦	木头木脑	木頭木腦	
木頭木緒	木头木绪	木頭木緒	
木箱	木箱	木箱	
木頭箱子	木头箱子	木頭箱子	
木匠	木匠	木匠	
木人	木人	木人	
木屐鞋	木屐鞋	木屐鞋	
木屐	木屐	木屐	
木屑板	木屑板	木屑板	
木耳	木耳	木耳	
摸	摸	摸	
摸蟹	摸蟹	摸蟹	
摸暗子	摸暗子	摸暗子	
摸六株	摸六株	摸六株	
墨水	墨水	墨水	
暴暗	暴暗	暴暗	
墨斗	墨斗	墨斗	
墨斗綫	墨斗线	墨斗線	
墨黑	墨黑	墨黑	
墨盒	墨盒	墨盒	
墨綠	墨绿	墨綠	
墨筆	墨笔	墨筆	
墨汁	墨汁	墨汁	
幅	幅	幅	
復習	复习	複習	
複寫紙	复写纸	複寫紙	
福氣	福气	福氣	
福分	福分	福分	
福橘	福橘	福橘	
覆蓋睏	覆盖困	覆蓋困	
伏勒睏	伏勒困	伏勒困	
伏裏	伏里	伏裏	
服	服	服	
服帖	服帖	服帖	
服服帖帖	服服帖帖	服服帖帖	
𡰪底	𡰪底	𡰪底	
𡰪壁	𡰪壁	𡰪壁	
𡰪塞弄堂	𡰪塞弄堂	𡰪塞弄堂	
𡰪壁日腳	𡰪壁日脚	𡰪壁日腳	
沰	沰	沰	
啄	啄	啄	
啄	啄	啄	
𧰵	𧰵	𧰵	
𧰵鼓	𧰵鼓	𧰵鼓	
𧰵更	𧰵更	𧰵更	
𧰵糖	𧰵糖	𧰵糖	
𧰵洞	𧰵洞	𧰵洞	
督○	督○	督○	
篤知	笃知	篤知	
篤坦	笃坦	篤坦	
篤悠悠	笃悠悠	篤悠悠	
篤長	笃长	篤長	
篤定	笃定	篤定	
篤篤定定	笃笃定定	篤篤定定	
篤定泰山	笃定泰山	篤定泰山	
篤鋒頭	笃锋头	篤鋒頭	
篤篤	笃笃	篤篤	
篤落	笃落	篤落	
篤落𡀂	笃落𡀂	篤落𡀂	
篤○舌頭	笃○舌头	篤○舌頭	
𧝴	𧝴	𧝴	
拓	拓	拓	
獨槽○嘴	独槽○嘴	獨槽○嘴	
獨眼龍	独眼龙	獨眼龍	
獨手落	独手落	獨手落	
獨○頭	独○头	獨○頭	
獨○頭獨○腦	独○头独○脑	獨○頭獨○腦	
獨養囡	独养囡	獨養囡	
獨養兒子	独养儿子	獨養兒子	
獨門心思	独门心思	獨門心思	
讀書	读书	讀書	
讀書人	读书人	讀書人	
睩	睩	睩	
摝	摝	摝	
摝鼓	摝鼓	摝鼓	
摝摝動	摝摝动	摝摝動	
六	六	六	
六號	六号	六號	
六斤四兩	六斤四两	六斤四兩	
六隻指末頭	六只指末头	六隻指末頭	
六穀	六谷	六穀	
六一	六一	六一	
六十一	六十一	六十一	
六二	六二	六二	
六兩	六两	六兩	
六三	六三	六三	
六四	六四	六四	
六五	六五	六五	
六六	六六	六六	
六七	六七	六七	
六八	六八	六八	
六九	六九	六九	
六十	六十	六十	
烙鐵	烙铁	烙鐵	
落	落	落	
落士	落士	落士	
落仕	落仕	落仕	
落市	落市	落市	
落水管	落水管	落水管	
落地	落地	落地	
落地雷	落地雷	落地雷	
落地頭	落地头	落地頭	
落去	落去	落去	
落露水	落露水	落露水	
落雨	落雨	落雨	
落雨天價	落雨天价	落雨天價	
落家房子	落家房子	落家房子	
落潮	落潮	落潮	
落檻	落槛	落檻	
落手	落手	落手	
落位	落位	落位	
落課	落课	落課	
落場勢	落场势	落場勢	
落弶老鼠	落弶老鼠	落弶老鼠	
落象	落象	落象	
落湯鷄	落汤鸡	落湯雞	
落霜	落霜	落霜	
落棺材	落棺材	落棺材	
落篷	落篷	落篷	
落軋	落轧	落軋	
落腳	落脚	落腳	
落腳茄	落脚茄	落腳茄	
落薄	落薄	落薄	
落拓	落拓	落拓	
落雪	落雪	落雪	
落殼○	落壳○	落殼○	
落直	落直	落直	
落落直直	落落直直	落落直直	
落月	落月	落月	
絡	络	絡	
絡亂	络乱	絡亂	
碌	碌	碌	
綠	绿	綠	
綠莧菜	绿苋菜	綠莧菜	
綠油油	绿油油	綠油油	
綠頭鴨	绿头鸭	綠頭鴨	
綠頭鴨	绿头鸭	綠頭鴨	
綠豆	绿豆	綠豆	
綠豆芽	绿豆芽	綠豆芽	
綠鬱鬱	绿郁郁	綠鬱郁	
漉	漉	漉	
漉筛油	漉筛油	漉篩油	
六四油	六四油	六四油	
樂惠	乐惠	樂惠	
樂樂惠惠	乐乐惠惠	樂樂惠惠	
樂得	乐得	樂得	
以	以	以	
駱駝	骆驼	駱駝	
駱駝蒲○薺	骆驼蒲○荠	駱駝蒲○薺	
竹	竹	竹	
竹字頭	竹字头	竹字頭	
竹椅子	竹椅子	竹椅子	
竹椅子	竹椅子	竹椅子	
竹椅子	竹椅子	竹椅子	
竹筱	竹筱	竹筱	
竹頭	竹头	竹頭	
竹牀	竹床	竹牀	
竹眠牀	竹眠床	竹眠牀	
竹管筒瓜	竹管筒瓜	竹管筒瓜	
竹針	竹针	竹針	
竹笋	竹笋	竹筍	
竹筆套管	竹笔套管	竹筆套管	
竹篾	竹篾	竹篾	
竹瀝	竹沥	竹瀝	
竹葉	竹叶	竹葉	
足	足	足	
足過又足	足过又足	足過又足	
足输贏	足输赢	足輸贏	
足球	足球	足球	
足心	足心	足心	
作	作	作	
作講	作讲	作講	
作吵	作吵	作吵	
作價	作价	作價	
作嬌	作娇	作嬌	
作頭	作头	作頭	
大包作頭	大包作头	大包作頭	
作梗	作梗	作梗	
作漿	作浆	作漿	
作文簿	作文簿	作文簿	
作忖	作忖	作忖	
作興	作兴	作興	
作準	作准	作準	
作啥	作啥	作啥	
作啥	作啥	作啥	
作啥幹	作啥干	作啥幹	
作啥幹	作啥干	作啥幹	
作啥體	作啥体	作啥體	
作啥體	作啥体	作啥體	
作孽	作孽	作孽	
斫	斫	斫	
斫樹	斫树	斫樹	
斫柴刀	斫柴刀	斫柴刀	
捉	捉	捉	
捉漏	捉漏	捉漏	
𡎺漏	𡎺漏	𡎺漏	
桌沿	桌沿	桌沿	
桌凳	桌凳	桌凳	
桌凳裏	桌凳里	桌凳裏	
桌凳高頭	桌凳高头	桌凳高頭	
桌凳上頭	桌凳上头	桌凳上頭	
啄木鳥	啄木鸟	啄木鳥	
粥	粥	粥	
粥飲湯	粥饮汤	粥飲湯	
瘃	瘃	瘃	
撮藥	撮药	撮藥	
䭁	䭁	䭁	
築○	筑○	築○	
促	促	促	
促	促	促	
促○移○	促○移○	促○移○	
戳戳動	戳戳动	戳戳動	
戳人勒色	戳人勒色	戳人勒色	
戳壁腳	戳壁脚	戳壁腳	
觸霉頭	触霉头	觸黴頭	
妯娌	妯娌	妯娌	
逐魂	逐魂	逐魂	
逐節	逐节	逐節	
逐日	逐日	逐日	
族裏人	族里人	族裏人	
族長	族长	族長	
㪬	㪬	㪬	
濁瘟頭	浊瘟头	濁瘟頭	
濁瘟	浊瘟	濁瘟	
濁○落羹	浊○落羹	濁○落羹	
…式	…式	…式	
戌	戌	戌	
束子	束子	束子	
叔婆	叔婆	叔婆	
叔伯姆	叔伯姆	叔伯姆	
叔公	叔公	叔公	
叔伯兄弟	叔伯兄弟	叔伯兄弟	
刷平	刷平	刷平	
刷刷平	刷刷平	刷刷平	
速朗	速朗	速朗	
索格	索格	索格	
敕	敕	敕	
敕鼻頭	敕鼻头	敕鼻頭	
啥	啥	啥	
啥	啥	啥	
啥	啥	啥	
啥幹	啥干	啥幹	
啥幹	啥干	啥幹	
啥幹	啥干	啥幹	
啥體	啥体	啥體	
啥體	啥体	啥體	
啥體	啥体	啥體	
啥人	啥人	啥人	
啥人	啥人	啥人	
啥人	啥人	啥人	
啥人家	啥人家	啥人家	
啥人家	啥人家	啥人家	
啥人家	啥人家	啥人家	
啥些	啥些	啥些	
啥西	啥西	啥西	
雪	雪	雪	
雪子	雪子	雪子	
雪麵	雪面	雪面	
雪裏蕻	雪里蕻	雪裏蕻	
雪裏紅	雪里红	雪裏紅	
雪花粉	雪花粉	雪花粉	
雪淡	雪淡	雪淡	
雪刮淡	雪刮淡	雪刮淡	
雪刮斯淡	雪刮斯淡	雪刮斯淡	
雪竇山風景區	雪窦山风景区	雪竇山風景區	
雪白	雪白	雪白	
雪雪白	雪雪白	雪雪白	
雪裏斯白	雪里斯白	雪裏斯白	
雪白粉嫩	雪白粉嫩	雪白粉嫩	
粟	粟	粟	
説話	说话	說話	
縮攏	缩拢	縮攏	
𢱢	𢱢	𢱢	
勺	勺	勺	
芍藥	芍药	芍藥	
昨末	昨末	昨末	
昨末	昨末	昨末	
昨密○	昨密○	昨密○	
昨密○	昨密○	昨密○	
昨密○子	昨密○子	昨密○子	
昨密○子	昨密○子	昨密○子	
昨末子	昨末子	昨末子	
昨末子	昨末子	昨末子	
昨日	昨日	昨日	
昨日	昨日	昨日	
昨日子	昨日子	昨日子	
昨日子	昨日子	昨日子	
熟	熟	熟	
熟地	熟地	熟地	
熟泥其	熟泥其	熟泥其	
熟鐵	熟铁	熟鐵	
鑿子	凿子	鑿子	
各到各采	各到各采	各到各採	
各到各處	各到各处	各到各處	
各號	各号	各號	
各樣	各样	各樣	
角麂	角麂	角麂	
角麂嘸郎	角麂呒郎	角麂嘸郎	
角票	角票	角票	
角頭	角头	角頭	
角頭角面	角头角面	角頭角面	
角角落落	角角落落	角角落落	
角尺	角尺	角尺	
角落頭	角落头	角落頭	
閣樓	阁楼	閣樓	
閣栅	阁栅	閣柵	
⿰火閣	⿰火阁	⿰火閣	
穀	谷	谷	
穀櫥	谷橱	谷櫥	
穀雨	谷雨	穀雨	
穀眼子	谷眼子	谷眼子	
穀眼烏珠	谷眼乌珠	谷眼烏珠	
穀籮	谷箩	谷籮	
穀籮頭	谷箩头	谷籮頭	
穀蜢	谷蜢	谷蜢	
穀倉	谷仓	穀倉	
擱田	搁田	擱田	
擱几	搁几	擱幾	
擱排凳	搁排凳	擱排凳	
擱沙	搁沙	擱沙	
擱廊	搁廊	擱廊	
擱板	搁板	擱板	
擱登	搁登	擱登	
擱碟	搁碟	擱碟	
覺着	觉着	覺着	
哭	哭	哭	
哭作面貌	哭作面貌	哭作面貌	
哭作環臉	哭作环脸	哭作環臉	
哭作無賴	哭作无赖	哭作無賴	
哭作包	哭作包	哭作包	
殼子	壳子	殼子	
殼貨	壳货	殼貨	
殼㝗	壳㝗	殼㝗	
殼落	壳落	殼落	
𤿩	𤿩	𤿩	
個	个	個	
擱	搁	擱	
☐☐郎	☐☐郎	☐☐郎	
鶴	鹤	鶴	
嗀	嗀	嗀	
霍亂吐瀉	霍乱吐泻	霍亂吐瀉	
霍新婦	霍新妇	霍新婦	
蜮蟲	蜮虫	蜮蟲	
學費	学费	學費	
學生	学生	學生	
學生子	学生子	學生子	
學生意	学生意	學生意	
學堂	学堂	學堂	
鑊	镬	鑊	
鑊子	镬子	鑊子	
鑊爿	镬爿	鑊爿	
鑊底	镬底	鑊底	
镬肚臍	镬肚脐	鑊肚臍	
镬瓢	镬瓢	鑊瓢	
鑊焦	镬焦	鑊焦	
镬滯	镬滞	鑊滯	
鑊蓋	镬盖	鑊蓋	
鑊鏟	镬铲	鑊鏟	
镬扛○	镬扛○	鑊扛○	
鑊墨灰	镬墨灰	鑊墨灰	
鑊墨灰	镬墨灰	鑊墨灰	
鑊煤	镬煤	鑊煤	
屋	屋	屋	
屋柱	屋柱	屋柱	
屋裏	屋里	屋裏	
屋落	屋落	屋落	
屋裏無賴	屋里无赖	屋裏無賴	
屋裏人	屋里人	屋裏人	
屋基地	屋基地	屋基地	
屋契	屋契	屋契	
屋檐	屋檐	屋檐	
屋爿	屋爿	屋爿	
屋山尖頭	屋山尖头	屋山尖頭	
屋頭登	屋头登	屋頭登	
屋後頭	屋后头	屋後頭	
屋頂	屋顶	屋頂	
屋脊	屋脊	屋脊	
屋業地主	屋业地主	屋業地主	
惡	恶	惡	
惡嘴眼相	恶嘴眼相	惡嘴眼相	
惡氣	恶气	惡氣	
惡氣倒出	恶气倒出	惡氣倒出	
惡嬲和	恶嬲和	惡嬲和	
惡蚊蟲	恶蚊虫	惡蚊蟲	
惡心	恶心	噁心	
惡心䑆䑆	恶心䑆䑆	噁心䑆䑆	
惡弄慫	恶弄怂	惡弄慫	
惡訟師	恶讼师	惡訟師	
惡刻	恶刻	惡刻	
喫水	吃水	吃水	
喫屁股	吃屁股	吃屁股	
喫死飯	吃死饭	吃死飯	
喫醋	吃醋	吃醋	
喫素	吃素	吃素	
喫軟弶	吃软弶	吃軟弶	
喫絞絲	吃绞丝	吃絞絲	
喫夜點心	吃夜点心	吃夜點心	
喫夜點心	吃夜点心	吃夜點心	
喫夜飯	吃夜饭	吃夜飯	
喫腦子卜	吃脑子卜	吃腦子卜	
喫牢	吃牢	吃牢	
喫老酒	吃老酒	吃老酒	
喫巴掌	吃巴掌	吃巴掌	
喫家生	吃家生	吃家生	
喫花菜	吃花菜	吃花菜	
喫菜	吃菜	吃菜	
吃齋	吃斋	吃齋	
喫開口飯個	吃开口饭个	吃開口飯個	
喫…飯	吃…饭	吃…飯	
喫飯店飯	吃饭店饭	吃飯店飯	
吃飯家生	吃饭家生	吃飯家生	
喫飯間	吃饭间	吃飯間	
喫飯桌凳	吃饭桌凳	吃飯桌凳	
喫僝頭	吃僝头	吃僝頭	
喫噴頭	吃喷头	吃噴頭	
喫排頭	吃排头	吃排頭	
吃蛋糕	吃蛋糕	吃蛋糕	
喫閑食	吃闲食	吃閒食	
喫酒	吃酒	吃酒	
吃喜酒	吃喜酒	吃喜酒	
喫賠賬	吃赔账	吃賠賬	
喫豆腐	吃豆腐	吃豆腐	
喫口	吃口	吃口	
喫後樸	吃后朴	吃後樸	
喫生活	吃生活	吃生活	
喫相	吃相	吃相	
喫長菜	吃长菜	吃長菜	
喫場	吃场	吃場	
喫食	吃食	吃食	
喫香	吃香	吃香	
喫香煙	吃香烟	吃香菸	
喫官司	吃官司	吃官司	
喫進	吃进	吃進	
喫白食	吃白食	吃白食	
喫没	吃没	吃沒	
喫髮郎	吃发郎	吃發郎	
喫髮頭郎	吃发头郎	吃發頭郎	
喫勿落	吃勿落	吃勿落	
喫勒落	吃勒落	吃勒落	
喫夾餅	吃夹饼	吃夾餅	
喫客	吃客	吃客	
喫落	吃落	吃落	
喫落腳	吃落脚	吃落腳	
喫茶	吃茶	吃茶	
喫喫我	吃吃我	吃吃我	
喫喫儂	吃吃侬	吃吃儂	
喫喫渠	吃吃渠	吃吃渠	
喫喫阿拉	吃吃阿拉	吃吃阿拉	
喫喫倷	吃吃倷	吃吃倷	
喫喫渠拉	吃吃渠拉	吃吃渠拉	
吃癟	吃瘪	吃癟	
喫天亮飯	吃天亮饭	吃天亮飯	
喫熱	吃热	吃熱	
玉蘭花	玉兰花	玉蘭花	
玉石	玉石	玉石	
肉	肉	肉	
肉絲	肉丝	肉絲	
肉絲糊臘	肉丝糊腊	肉絲糊臘	
肉片	肉片	肉片	
肉皮	肉皮	肉皮	
肉店	肉店	肉店	
肉裏眼	肉里眼	肉裏眼	
肉圓	肉圆	肉圓	
肉麻	肉麻	肉麻	
肉彩	肉彩	肉彩	
肉油	肉油	肉油	
肉膛	肉膛	肉膛	
肉餅子燉蛋	肉饼子炖蛋	肉餅子燉蛋	
肉餅子	肉饼子	肉餅子	
肉醬	肉酱	肉醬	
肉丁	肉丁	肉丁	
肉釘	肉钉	肉釘	
肉凍	肉冻	肉凍	
肉痛	肉痛	肉痛	
肉鬆	肉松	肉鬆	
肉勿𤿏	肉勿𤿏	肉勿𤿏	
肉割割	肉割割	肉割割	
肉及○及○	肉及○及○	肉及○及○	
肉骨及○及○	肉骨及○及○	肉骨及○及○	
肉骨實實	肉骨实实	肉骨實實	
𢫭	𢫭	𢫭	
必○	必○	必○	
必○	必○	必○	
必○過	必○过	必○過	
畢發畢準	毕发毕准	畢發畢準	
畢業	毕业	畢業	
𤎨	𤎨	𤎨	
筆	笔	筆	
筆尖	笔尖	筆尖	
筆筆尖	笔笔尖	筆筆尖	
筆篤尖	笔笃尖	筆篤尖	
筆篤斯尖	笔笃斯尖	筆篤斯尖	
筆筆斯尖	笔笔斯尖	筆筆斯尖	
筆記簿	笔记簿	筆記簿	
筆套管	笔套管	筆套管	
筆架	笔架	筆架	
筆頭	笔头	筆頭	
筆挺	笔挺	筆挺	
筆筒	笔筒	筆筒	
筆劃	笔划	筆劃	
筆順	笔顺	筆順	
筆墨莊	笔墨庄	筆墨莊	
筆篤	笔笃	筆篤	
筆篤斯直	笔笃斯直	筆篤斯直	
筆篤翹	笔笃翘	筆篤翹	
筆直	笔直	筆直	
碧綠	碧绿	碧綠	
碧碧綠	碧碧绿	碧碧綠	
碧綠青翠	碧绿青翠	碧綠青翠	
潷	滗	潷	
壁虎	壁虎	壁虎	
壁老虎	壁老虎	壁老虎	
壁蟹	壁蟹	壁蟹	
壁角	壁角	壁角	
壁角落頭	壁角落头	壁角落頭	
癟嘴	瘪嘴	癟嘴	
癟嘴癟得	瘪嘴瘪得	癟嘴癟得	
癟三	瘪三	癟三	
癟骸骸	瘪骸骸	癟骸骸	
癟螺痧	瘪螺痧	癟螺痧	
癟塌塌	瘪塌塌	癟塌塌	
癟落	瘪落	癟落	
鱉	鳖	鱉	
匹	匹	匹	
䏘	䏘	䏘	
撇	撇	撇	
霹靂	霹雳	霹靂	
别	别	別	
别采	别采	別採	
别烏○采○	别乌○采○	別烏○采○	
别烏○蕩○	别乌○荡○	別烏○蕩○	
别烏○態○	别乌○态○	別烏○態○	
别烏○頭○	别乌○头○	別烏○頭○	
别𡍲	别𡍲	別𡍲	
别轉	别转	別轉	
别樣	别样	別樣	
别樣告	别样告	別樣告	
别針	别针	別針	
别人家	别人家	別人家	
别别跳	别别跳	別別跳	
别十	别十	別十	
笓	笓	笓	
鼻翼	鼻翼	鼻翼	
𧼱	𧼱	𧼱	
𧼱勿着	𧼱勿着	𧼱勿着	
𧼱出	𧼱出	𧼱出	
𤐧	𤐧	𤐧	
蹩	蹩	蹩	
蹩腳	蹩脚	蹩腳	
蹩腳貨	蹩脚货	蹩腳貨	
嘸没	呒没	嘸沒	
嘸没咋	呒没咋	嘸沒咋	
嘸没大	呒没大	嘸沒大	
嘸没啥好	呒没啥好	嘸沒啥好	
嘸没啥好	呒没啥好	嘸沒啥好	
嘸没心事	呒没心事	嘸沒心事	
嘸没用場	呒没用场	嘸沒用場	
嘸没只幾日	呒没只几日	嘸沒只幾日	
密	密	密	
密密緊	密密紧	密密緊	
密擦緊	密擦紧	密擦緊	
搣	搣	搣	
搣特郎	搣特郎	搣特郎	
蜜甜	蜜甜	蜜甜	
蜜蜜甜	蜜蜜甜	蜜蜜甜	
蜜糖	蜜糖	蜜糖	
蜜蜂	蜜蜂	蜜蜂	
蜜筒瓜	蜜筒瓜	蜜筒瓜	
蔑牑	蔑牑	蔑牑	
蔑青	蔑青	蔑青	
蔑白	蔑白	蔑白	
蔑竹	蔑竹	蔑竹	
篾席	篾席	篾席	
扚	扚	扚	
的	的	的	
的仔	的仔	的仔	
的𡀂	的𡀂	的𡀂	
的剝落	的剥落	的剝落	
的薄	的薄	的薄	
的薄裏	的薄里	的薄裏	
的的薄	的的薄	的的薄	
菲菲薄	菲菲薄	菲菲薄	
的篤班	的笃班	的篤班	
的落花	的落花	的落花	
的角方	的角方	的角方	
的的刮刮	的的刮刮	的的刮刮	
跌倒勢講	跌倒势讲	跌倒勢講	
跌落	跌落	跌落	
滴	滴	滴	
滴子	滴子	滴子	
滴水下	滴水下	滴水下	
天亮	天亮	天亮	
天亮頭	天亮头	天亮頭	
天亮飯	天亮饭	天亮飯	
踢燕○子	踢燕○子	踢燕○子	
踢土旁	踢土旁	踢土旁	
踢腳綫	踢脚线	踢腳線	
鐵	铁	鐵	
鐵絲揢蘿	铁丝揢萝	鐵絲揢蘿	
鐵樹	铁树	鐵樹	
鐵路	铁路	鐵路	
鐵耙	铁耙	鐵耙	
鐵車	铁车	鐵車	
鐵鍬	铁锹	鐵鍬	
鐵抄	铁抄	鐵抄	
鐵蛋	铁蛋	鐵蛋	
鐵銹紅	铁锈红	鐵鏽紅	
鐵軌	铁轨	鐵軌	
鐵灰	铁灰	鐵灰	
鐵匠	铁匠	鐵匠	
鐵防	铁防	鐵防	
鐵行	铁行	鐵行	
鐵凳	铁凳	鐵凳	
鐵撲落	铁扑落	鐵撲落	
糴米	籴米	糴米	
力道	力道	力道	
立	立	立	
立時三刻	立时三刻	立時三刻	
立字據	立字据	立字據	
立早章	立早章	立早章	
立夏	立夏	立夏	
立秋	立秋	立秋	
立春	立春	立春	
立冬	立冬	立冬	
立壁角	立壁角	立壁角	
列	列	列	
律師	律师	律師	
栗子	栗子	栗子	
栗子番薯	栗子番薯	栗子番薯	
栗子肉	栗子肉	栗子肉	
栗殼色	栗壳色	慄殼色	
粒	粒	粒	
粒粒瘃瘃	粒粒瘃瘃	粒粒瘃瘃	
𢯰	𢯰	𢯰	
癧串	疬串	癧串	
癧子頸	疬子颈	癧子頸	
䉭	䉭	䉭	
䉭子	䉭子	䉭子	
今密○	今密○	今密○	
今密○子	今密○子	今密○子	
汁○	汁○	汁○	
汁水	汁水	汁水	
汁水湯	汁水汤	汁水湯	
只勿	只勿	只勿	
只勒	只勒	只勒	
只只	只只	只只	
灼	灼	灼	
灼辣辣	灼辣辣	灼辣辣	
迹浞	迹浞	跡浞	
急	急	急	
急鼓鼓	急鼓鼓	急鼓鼓	
急綳綳	急绷绷	急繃繃	
急驚風	急惊风	急驚風	
急急動	急急动	急急動	
級○	级○	級○	
𢆚	𢆚	𢆚	
脊柱骨	脊柱骨	脊柱骨	
接○下飯	接○下饭	接○下飯	
敧下飯	敧下饭	敧下飯	
接頭	接头	接頭	
接口令	接口令	接口令	
接生	接生	接生	
接生老娘	接生老娘	接生老孃	
接生婆	接生婆	接生婆	
接龍	接龙	接龍	
揭方巾	揭方巾	揭方巾	
結珠	结珠	結珠	
結蛛亂網	结蛛乱网	結蛛亂網	
結𥀬	结𥀬	結𥀬	
結拜兄弟	结拜兄弟	結拜兄弟	
結拜弟兄	结拜弟兄	結拜弟兄	
結彩	结彩	結綵	
結頭	结头	結頭	
結冰	结冰	結冰	
結棍	结棍	結棍	
結髮夫妻	结发夫妻	結髮夫妻	
結夾	结夹	結夾	
節	节	節	
節邊	节边	節邊	
節頭節面	节头节面	節頭節面	
節肯	节肯	節肯	
節日頭間	节日头间	節日頭間	
漬	渍	漬	
漬煞	渍煞	漬煞	
摺扇	折扇	摺扇	
摺烏○	折乌○	折烏○	
摺傘	折伞	折傘	
摺襇	折裥	折襉	
摺尺	折尺	摺尺	
羯豬	羯猪	羯豬	
羯鷄	羯鸡	羯雞	
羯狗娘	羯狗娘	羯狗娘	
羯牛	羯牛	羯牛	
積肥	积肥	積肥	
積落	积落	積落	
積食	积食	積食	
織布機	织布机	織布機	
織績蟲	织绩虫	織績蟲	
䥛子刀	䥛子刀	䥛子刀	
七	七	七	
七嘴八舌	七嘴八舌	七嘴八舌	
七纏八纏	七缠八缠	七纏八纏	
七死八活	七死八活	七死八活	
七依八𠡒	七依八𠡒	七依八𠡒	
七錯八戤	七错八戤	七錯八戤	
七搞八搞	七搞八搞	七搞八搞	
搞七廿三	搞七廿三	搞七廿三	
七高八低	七高八低	七高八低	
七號	七号	七號	
七彎涼牀	七弯凉床	七彎涼牀	
七手八腳	七手八脚	七手八腳	
七頭清	七头清	七頭清	
七長八短	七长八短	七長八短	
七上八落	七上八落	七上八落	
七講八講	七讲八讲	七講八講	
七拼八湊	七拼八凑	七拼八湊	
七衝八跌	七冲八跌	七衝八跌	
七搭八搭	七搭八搭	七搭八搭	
七石缸	七石缸	七石缸	
七簇星	七簇星	七簇星	
七一	七一	七一	
七十一	七十一	七十一	
七二	七二	七二	
七三	七三	七三	
七四	七四	七四	
七五	七五	七五	
七六	七六	七六	
七七	七七	七七	
七八	七八	七八	
七九	七九	七九	
七月半	七月半	七月半	
七月七	七月七	七月七	
七十	七十	七十	
切麵	切面	切面	
切切克克	切切克克	切切剋剋	
赤泡茶	赤泡茶	赤泡茶	
赤砂糖	赤砂糖	赤砂糖	
䜉䜉觸○觸○	䜉䜉触○触○	䜉䜉觸○觸○	
怯霍○	怯霍○	怯霍○	
挈	挈	挈	
挈水	挈水	挈水	
挈後腳	挈后脚	挈後腳	
挈當	挈当	挈當	
挈當桶	挈当桶	挈當桶	
挈斤兩	挈斤两	挈斤兩	
挈夾	挈夹	挈夾	
挈出尿瓶	挈出尿瓶	挈出尿瓶	
喫力	吃力	吃力	
皵	皵	皵	
𤷾落	𤷾落	𤷾落	
漆蒿蒿	漆蒿蒿	漆蒿蒿	
漆匠	漆匠	漆匠	
漆○落	漆○落	漆○落	
慼慼動	戚戚动	慼慼動	
撤職	撤职	撤職	
緝鞋底	缉鞋底	緝鞋底	
及味	及味	及味	
及○港○	及○港○	及○港○	
直	直	直	
直利利	直利利	直利利	
直白白	直白白	直白白	
直肚白腸	直肚白肠	直肚白腸	
直頭白腦	直头白脑	直頭白腦	
直過	直过	直過	
直直過	直直过	直直過	
直頭牛	直头牛	直頭牛	
直門關	直门关	直門關	
直籠統	直笼统	直籠統	
姪囡	侄囡	侄囡	
值鈿	值钿	值鈿	
渠拉	渠拉	渠拉	
渠拉兩人	渠拉两人	渠拉兩人	
渠拉個	渠拉个	渠拉個	
極䪆	极䪆	極䪆	
劇	剧	劇	
𢷒	𢷒	𢷒	
擲色子	掷色子	擲色子	
日裏	日里	日裏	
日裏頭	日里头	日裏頭	
日加日	日加日	日加日	
日間日	日间日	日間日	
日隔日	日隔日	日隔日	
日頭	日头	日頭	
日頭菩薩	日头菩萨	日頭菩薩	
日頭菩	日头菩	日頭菩	
日頭底下	日头底下	日頭底下	
日頭下底	日头下底	日頭下底	
日頭菩裏	日头菩里	日頭菩裏	
日長夜大	日长夜大	日長夜大	
日長四○久	日长四○久	日長四○久	
日場	日场	日場	
日腳	日脚	日腳	
日日	日日	日日	
熱水	热水	熱水	
熱水袋	热水袋	熱水袋	
熱水瓶	热水瓶	熱水瓶	
熱面孔貼冷屁股	热面孔贴冷屁股	熱面孔貼冷屁股	
熱天價	热天价	熱天價	
熱氣肉	热气肉	熱氣肉	
熱度度	热度度	熱度度	
熱炒盆	热炒盆	熱炒盆	
熱黄梅	热黄梅	熱黃梅	
熱門貨	热门货	熱門貨	
熱昏	热昏	熱昏	
熱溫吞	热温吞	熱溫吞	
熱溫溫	热温温	熱溫溫	
熱烔烔	热烔烔	熱烔烔	
熱拔拔	热拔拔	熱拔拔	
熱拆	热拆	熱拆	
熱拆骨頭	热拆骨头	熱拆骨頭	
熱石○	热石○	熱石○	
熱絡	热络	熱絡	
熱瘃癗	热瘃癗	熱瘃癗	
熱瘃頭	热瘃头	熱瘃頭	
熱食	热食	熱食	
鑷子鉗	镊子钳	鑷子鉗	
吸○	吸○	吸○	
吸鐵石	吸铁石	吸鐵石	
吸血蟲	吸血虫	吸血蟲	
些些	些些	些些	
息肉	息肉	息肉	
瘜肉	瘜肉	瘜肉	
息息介	息息介	息息介	
歇	歇	歇	
歇過	歇过	歇過	
歇一歇	歇一歇	歇一歇	
錫	锡	錫	
錫瓶飯盂	锡瓶饭盂	錫瓶飯盂	
錫瓶	锡瓶	錫瓶	
錫箔	锡箔	錫箔	
濕氣	湿气	溼氣	
濕扎扎	湿扎扎	溼扎扎	
識字	识字	識字	
識相	识相	識相	
㽺	㽺	㽺	
㽺東東	㽺东东	㽺東東	
攝○	摄○	攝○	
舌苔	舌苔	舌苔	
舌頭	舌头	舌頭	
食指	食指	食指	
食包	食包	食包	
食罩	食罩	食罩	
食品店	食品店	食品店	
席子	席子	席子	
席席嫩	席席嫩	席席嫩	
蝕	蚀	蝕	
蝕本	蚀本	蝕本	
該	该	該	
該面	该面	該面	
該廂	该厢	該廂	
該岸	该岸	該岸	
該記	该记	該記	
該遭	该遭	該遭	
該毛○	该毛○	該毛○	
該回	该回	該回	
該眼	该眼	該眼	
該個月	该个月	該個月	
該個月	该个月	該個月	
該槍○	该枪○	該槍○	
該槍○裏	该枪○里	該槍○裏	
該晌	该晌	該晌	
該晌裏	该晌里	該晌裏	
該𡍲	该𡍲	該𡍲	
該底	该底	該底	
該底把	该底把	該底把	
該個	该个	該個	
該個	该个	該個	
𢖺𢖺動	𢖺𢖺动	𢖺𢖺動	
頁	页	頁	
頁薄	页薄	頁薄	
頁薄裏	页薄里	頁薄裏	
頁頁裏	页页里	頁頁裏	
枼薄	枼薄	枼薄	
枼薄裏	枼薄里	枼薄裏	
枼枼裏	枼枼里	枼枼裏	
拽	拽	拽	
翼梢	翼梢	翼梢	
翼梢膀	翼梢膀	翼梢膀	
一	一	一	
一時裏	一时里	一時裏	
一時三刻	一时三刻	一時三刻	
一字領	一字领	一字領	
—禮拜	—礼拜	—禮拜	
一千	一千	一千	
一千九百	一千九百	一千九百	
一千九	一千九	一千九	
一千一百	一千一百	一千一百	
一千一	一千一	一千一	
一千兩	一千两	一千兩	
一千二	一千二	一千二	
一千三	一千三	一千三	
一千四	一千四	一千四	
一千五	一千五	一千五	
一千六	一千六	一千六	
一千七	一千七	一千七	
一千八	一千八	一千八	
一千九	一千九	一千九	
一年到頭	一年到头	一年到頭	
一步裙	一步裙	一步裙	
一舉兩得	一举两得	一舉兩得	
一帶兩便	一带两便	一帶兩便	
一包一作○	一包一作○	一包一作○	
一到	一到	一到	
一到裏	一到里	一到裏	
一到來	一到来	一到來	
一號	一号	一號	
一把紮	一把扎	一把扎	
一家老小	一家老小	一家老小	
一潮	一潮	一潮	
一萬	一万	一萬	
一萬兩千	一万两千	一萬兩千	
一萬二	一万二	一萬二	
一萬兩	一万两	一萬兩	
一萬一	一万一	一萬一	
一萬三	一万三	一萬三	
一萬四	一万四	一萬四	
一萬五	一万五	一萬五	
一萬六	一万六	一萬六	
一萬七	一万七	一萬七	
一萬八	一万八	一萬八	
一萬九	一万九	一萬九	
一眼眼	一眼眼	一眼眼	
一眼一沰	一眼一沰	一眼一沰	
一眼嘸告	一眼呒告	一眼嘸告	
一轉一回	一转一回	一轉一回	
一進一出	一进一出	一進一出	
一來一去	一来一去	一來一去	
一手落	一手落	一手落	
一手一腳	一手一脚	一手一腳	
一桅船	一桅船	一桅船	
兩桅船	两桅船	兩桅船	
三桅船	三桅船	三桅船	
一大半	一大半	一大半	
一頭…一頭…	一头…一头…	一頭…一頭…	
一遘盡	一遘尽	一遘盡	
一口鐘	一口钟	一口鐘	
一打一挼	一打一挼	一打一挼	
一記打，一記挼	一记打，一记挼	一記打，一記挼	
一生世	一生世	一生世	
一生一世	一生一世	一生一世	
一兩里路	一两里路	一兩里路	
一張分	一张分	一張分	
一長二短	一长二短	一長二短	
一樣	一样	一樣	
一晌	一晌	一晌	
一半	一半	一半	
一門心思	一门心思	一門心思	
一釘一眼	一钉一眼	一釘一眼	
一清兩楚	一清两楚	一清兩楚	
一人	一人	一人	
一百	一百	一百	
一百十一	一百十一	一百十一	
一百十	一百十	一百十	
一百一	一百一	一百一	
一百二	一百二	一百二	
一百兩	一百两	一百兩	
一百三	一百三	一百三	
一百四	一百四	一百四	
一百五	一百五	一百五	
一百六	一百六	一百六	
一百七	一百七	一百七	
一百八	一百八	一百八	
一百九	一百九	一百九	
一搭一檔	一搭一档	一搭一檔	
一塌刮子	一塌刮子	一塌刮子	
一隻角子	一只角子	一隻角子	
一色一樣	一色一样	一色一樣	
一隔○周	一隔○周	一隔○周	
一腳勢	一脚势	一腳勢	
一沰	一沰	一沰	
一沰漿	一沰浆	一沰漿	
一桌酒水	一桌酒水	一桌酒水	
一個	一个	一個	
一個	一个	一個	
一直鼻頭	一直鼻头	一直鼻頭	
一日	一日	一日	
一日到夜	一日到夜	一日到夜	
一一仄仄	一一仄仄	一一仄仄	
乙	乙	乙	
𨉖	𨉖	𨉖	
𨉖壁賊	𨉖壁贼	𨉖壁賊	
噔煞	噔煞	噔煞	
擪	擪	擪	
𥣘	𥣘	𥣘	
𥣘子	𥣘子	𥣘子	
菊花	菊花	菊花	
厥起	厥起	厥起	
橘子	橘子	橘子	
橘子時	橘子时	橘子時	
橘子汛裏	橘子汛里	橘子汛裏	
橘子水	橘子水	橘子水	
橘黄	橘黄	橘黃	
橘紅	橘红	橘紅	
橘絡	橘络	橘絡	
曲○格	曲○格	曲○格	
缺	缺	缺	
缺嘴	缺嘴	缺嘴	
缺嘴弄	缺嘴弄	缺嘴弄	
缺牙弄	缺牙弄	缺牙弄	
缺頭	缺头	缺頭	
缺秤	缺秤	缺秤	
局○	局○	局○	
局氣	局气	局氣	
掘樹	掘树	掘樹	
掘地	掘地	掘地	
掘稻根	掘稻根	掘稻根	
𧤼	𧤼	𧤼	
鐲頭	镯头	鐲頭	
血	血	血	
血印	血印	血印	
血紅	血红	血紅	
血出糊賴	血出糊赖	血出糊賴	
㜅	㜅	㜅	
㜅門	㜅门	㜅門	
㜅頭	㜅头	㜅頭	
噱	噱	噱	
月	月	月	
月底邊	月底边	月底邊	
月底	月底	月底	
月季	月季	月季	
月初	月初	月初	
月湖	月湖	月湖	
月家	月家	月家	
月小	月小	月小	
月大	月大	月大	
月亮	月亮	月亮	
月亮菩薩	月亮菩萨	月亮菩薩	
月亮菩	月亮菩	月亮菩	
月亮底下	月亮底下	月亮底下	
月亮下底	月亮下底	月亮下底	
月亮地裏	月亮地里	月亮地裏	
月光	月光	月光	
月半	月半	月半	
月半邊	月半边	月半邊	
月份	月份	月份	
月份牌	月份牌	月份牌	
月餅	月饼	月餅	
月暈	月晕	月暈	
月洞門	月洞门	月洞門	
月中	月中	月中	
月白	月白	月白	
浴室	浴室	浴室	
越○	越○	越○	
越加	越加	越加	
越劇	越剧	越劇	
越獄	越狱	越獄	
𢺴	𢺴	𢺴	
噦	哕	噦	
噦氣勿轉	哕气勿转	噦氣勿轉	
噦噦塞塞	哕哕塞塞	噦噦塞塞	
鬱	郁	鬱	
鬱拔拔	郁拔拔	鬱拔拔	
𢺴○	𢺴○	𢺴○	
唶	唶	唶	
㔃	㔃	㔃	
出	出	出	
出事體	出事体	出事體	
出天	出天	出天	
出天相	出天相	出天相	
出天露勢	出天露势	出天露勢	
出田	出田	出田	
出鷄屙	出鸡屙	出雞屙	
出氣	出气	出氣	
出道	出道	出道	
出家	出家	出家	
出家人	出家人	出家人	
出嫁	出嫁	出嫁	
出䠷	出䠷	出䠷	
出眼涙	出眼涙	出眼涙	
出閑話	出闲话	出閒話	
出手	出手	出手	
出梅	出梅	出梅	
出霉	出霉	出黴	
出窠娘	出窠娘	出窠娘	
出頭	出头	出頭	
出頭椽子	出头椽子	出頭椽子	
出頭髮	出头发	出頭發	
出賬	出账	出賬	
出搶花	出抢花	出搶花	
出洋相	出洋相	出洋相	
出榜	出榜	出榜	
出喪	出丧	出喪	
出門	出门	出門	
方去	方去	方去	
出送	出送	出送	
出空	出空	出空	
出格	出格	出格	
出腳	出脚	出腳	
出腳泥螺	出脚泥螺	出腳泥螺	
出腳大仙	出脚大仙	出腳大仙	
出血	出血	出血	
齣	出	出	
失○	失○	失○	
失面子	失面子	失面子	
失撇	失撇	失撇	
入賛女婿	入賛女婿	入賛女婿	
入梅	入梅	入梅	
入霉	入霉	入黴	
十	十	十	
十殿闕王	十殿阙王	十殿闕王	
十二月	十二月	十二月	
十外	十外	十外	
十號	十号	十號	
十三點	十三点	十三點	
十多個	十多个	十多個	
十多個	十多个	十多個	
十多日	十多日	十多日	
十個	十个	十個	
十個	十个	十個	
十一	十一	十一	
日暈	日晕	日暈	
實惠	实惠	實惠	
實實惠惠	实实惠惠	實實惠惠	
實貨	实货	實貨	
實叠牆	实叠墙	實疊牆	
實别别	实别别	實別別	
姆媽	姆妈	姆媽	
嘸	呒	嘸	
嘸趣相	呒趣相	嘸趣相	
嘸氣懶魄	呒气懒魄	嘸氣懶魄	
嘸氣嘸魄	呒气呒魄	嘸氣嘸魄	
嘸數	呒数	嘸數	
嘸數目賬	呒数目账	嘸數目賬	
嘸數倒賬	呒数倒账	嘸數倒賬	
嘸介事	呒介事	嘸介事	
嘸陶成	呒陶成	嘸陶成	
嘸陶白成	呒陶白成	嘸陶白成	
嘸陶西成	呒陶西成	嘸陶西成	
嘸告	呒告	嘸告	
嘸告話頭	呒告话头	嘸告話頭	
嘸告多少	呒告多少	嘸告多少	
嘸彫督	呒雕督	嘸雕督	
嘸掉	呒掉	嘸掉	
嘸要得緊	呒要得紧	嘸要得緊	
嘸采○去	呒采○去	嘸採○去	
嘸覃頭	呒覃头	嘸覃頭	
嘸做	呒做	嘸做	
嘸用場	呒用场	嘸用場	
嘸没用場	呒没用场	嘸沒用場	
嘸頭年出	呒头年出	嘸頭年出	
撫頭鬼	抚头鬼	撫頭鬼	
嘸頭帖子	呒头帖子	嘸頭帖子	
嘸長進	呒长进	嘸長進	
嘸賬得算	呒账得算	嘸賬得算	
嘸相干	呒相干	嘸相干	
嘸相量	呒相量	嘸相量	
嘸郎	呒郎	嘸郎	
嘸郎黄狗	呒郎黄狗	嘸郎黃狗	
嘸郎黄狗	呒郎黄狗	嘸郎黃狗	
嘸本	呒本	嘸本	
嘸根腳	呒根脚	嘸根腳	
嘸進嘸出	呒进呒出	嘸進嘸出	
嘸清頭	呒清头	嘸清頭	
嘸心到事	呒心到事	嘸心到事	
嘸弄頭	呒弄头	嘸弄頭	
嘸搭頭	呒搭头	嘸搭頭	
嘸落頭	呒落头	嘸落頭	
嘸腳蟹	呒脚蟹	嘸腳蟹	
嘸腳色	呒脚色	嘸腳色	
嘸腳活孫	呒脚活孙	嘸腳活孫	
嘸腳力	呒脚力	嘸腳力	
嘸說話	呒说话	嘸說話	
嘸話嘸說	呒话呒说	嘸話嘸說	
嘸角菱	呒角菱	嘸角菱	
嘸結果	呒结果	嘸結果	
嘸設法	呒设法	嘸設法	
嘸出山	呒出山	嘸出山	
芋艿	芋艿	芋艿	
芋艿子	芋艿子	芋艿子	
芋艿頭	芋艿头	芋艿頭	
芋艿蓊	芋艿蓊	芋艿蓊	
芋艿蓊蟲	芋艿蓊虫	芋艿蓊蟲	
芋艿蓊癟	芋艿蓊瘪	芋艿蓊癟	
兒子	儿子	兒子	
兒囡	儿囡	兒囡	
兒囡	儿囡	兒囡	
兒子囡	儿子囡	兒子囡	
魚子	鱼子	魚子	
魚翅	鱼翅	魚翅	
魚圓	鱼圆	魚圓	
魚泡泡	鱼泡泡	魚泡泡	
魚草	鱼草	魚草	
魚膠	鱼胶	魚膠	
魚腮	鱼腮	魚腮	
魚籮	鱼箩	魚籮	
魚秧	鱼秧	魚秧	
魚盆	鱼盆	魚盆	
魚鱗	鱼鳞	魚鱗	
魚鱗斑	鱼鳞斑	魚鱗斑	
魚鮏	鱼鮏	魚鮏	
魚白	鱼白	魚白	
魚骨頭	鱼骨头	魚骨頭	
五	五	五	
五事	五事	五事	
五千	五千	五千	
五號	五号	五號	
五花八門	五花八门	五花八門	
五花肉	五花肉	五花肉	
五海大碗	五海大碗	五海大碗	
五斗櫥	五斗橱	五斗櫥	
五更鷄	五更鸡	五更雞	
五更曉	五更晓	五更曉	
五更頭	五更头	五更頭	
五更	五更	五更	
五香粉	五香粉	五香粉	
五臟	五脏	五臟	
五臟六肺	五脏六肺	五臟六肺	
五穀	五谷	五穀	
五一	五一	五一	
五十一	五十一	五十一	
五二	五二	五二	
五兩	五两	五兩	
五三	五三	五三	
五四	五四	五四	
五五	五五	五五	
五六	五六	五六	
五七	五七	五七	
五八	五八	五八	
五九	五九	五九	
五十	五十	五十	
耳朵	耳朵	耳朵	
耳朵	耳朵	耳朵	
耳朵墜	耳朵坠	耳朵墜	
耳朵墜	耳朵坠	耳朵墜	
耳朵宕頭	耳朵宕头	耳朵宕頭	
耳朵宕頭	耳朵宕头	耳朵宕頭	
耳朵皮	耳朵皮	耳朵皮	
耳朵皮	耳朵皮	耳朵皮	
耳朵爿	耳朵爿	耳朵爿	
耳朵爿	耳朵爿	耳朵爿	
耳朵皮軟	耳朵皮软	耳朵皮軟	
耳朵皮軟	耳朵皮软	耳朵皮軟	
耳朵皮鑊	耳朵皮镬	耳朵皮鑊	
耳朵皮鑊	耳朵皮镬	耳朵皮鑊	
耳朵屙	耳朵屙	耳朵屙	
耳朵屙	耳朵屙	耳朵屙	
耳朵旁	耳朵旁	耳朵旁	
耳朵旁	耳朵旁	耳朵旁	
耳朵洞眼	耳朵洞眼	耳朵洞眼	
耳朵洞眼	耳朵洞眼	耳朵洞眼	
俉	俉	俉	
俉儂	俉侬	俉儂	
俉倷	俉倷	俉倷	
俉倷個	俉倷个	俉倷個	
俉個	俉个	俉個	
俉儂個	俉侬个	俉儂個	
孲𤘅	孲𤘅	孲𤘅	
